ಅಂತಹ	AH N T AH HH
ಅಂಥ	AH N TH
ಅಂದರೆ	AH N D AH R EY
ಅಂಶ	AH N SH
ಅಕಡೆಮಿಕ್	AH K AH D EY M IH K
ಅಡ್ಯೆಗಿಂತ	AH D Y EY G IH N T
ಅಣ್ಣ	AH N N
ಅಣ್ಣನೊಂದಿಗೆ	AH N N AH N OW N D IH G EY
ಅತಿ	AH T IH
ಅತಿಕ್ರಮಣ	AH T IH K R AH M AH N
ಅತ್ತೆಗೆ	AH T T EY G EY
ಅತ್ತೆಯನ್ನು	AH T T EY Y AH N N UH
ಅಥವಾ	AH TH AH W AA
ಅದಕ್ಕಾಗಿ	AH D AH K K AA G IH
ಅದಕ್ಕೆ	AH D AH K K EY
ಅದನ್ನು	AH D AH N N UH
ಅದರ	AH D AH R
ಅದರಲ್ಲೊಂದು	AH D AH R AH L L OW N D UH
ಅದರಿಂದಾಗಿ	AH D AH R IH N D AA G IH
ಅದು	AH D UH
ಅದೃಶ್ಯ	AH D R IH SH Y
ಅದೇ	AH D AE
ಅಧಿಕಾರ	AH DH IH K AA R
ಅಧಿಕಾರವಾಗಿರಲಿಲ್ಲ	AH DH IH K AA R AH W AA G IH R AH L IH L L
ಅಧಿಕಾರವು	AH DH IH K AA R AH W UH
ಅಧಿಕಾವು	AH DH IH K AA W UH
ಅಧ್ಯಕ್ಷರಲ್ಲಿ	AH DH Y AH K SH AH R AH L L IH
ಅಧ್ಯಯನ	AH DH Y AH Y AH N
ಅಧ್ಯಯನಕ್ಕೆ	AH DH Y AH Y AH N AH K K EY
ಅಧ್ಯಾಯವೇ	AH DH Y AA Y AH W AE
ಅನಂತರ	AH N AH N T AH R
ಅನಿವಾರ್ಯ	AH N IH W AA R Y
ಅನಿಷ್ಟವಾದದ್ದೂ	AH N IH SH T AH W AA D AH D D UW
ಅನುಜ್ಞೆ	AH N UH JH N EY
ಅನುಭವಿಸಿತು	AH N UH B HH AH W IH S IH T UH
ಅನುಭವಿಸಿದನು	AH N UH B HH AH W IH S IH D AH N UH
ಅನುವಾದದೊಂದಿಗೆ	AH N UH W AA D AH D OW N D IH G EY
ಅಪರಾಧವೆಂದೇ	AH P AH R AA DH AH W EY N D AE
ಅಪರೂಪ	AH P AH R UW P
ಅಪಾಯದಿಂದ	AH P AA Y AH D IH N D
ಅಪಾರ	AH P AA R
ಅಪಾರವಾಗಿತ್ತು	AH P AA R AH W AA G IH T T UH
ಅಭದ್ರತೆಯಿಂದ	AH B HH AH D R AH T EY Y IH N D
ಅಮರತ್ವ	AH M AH R AH T W
ಅಮರನಾಗಿರುವನು	AH M AH R AH N AA G IH R UH W AH N UH
ಅಮಾನವೀಯ	AH M AA N AH W IY Y
ಅಮೆರಿಕಾ	AH M EY R IH K AA
ಅಮೊನ್	AH M OW N
ಅರಬ	AH R AH B
ಅರಬರ	AH R AH B AH R
ಅರಸೀಕೆರೆ	AH R AH S IY K EY R EY
ಅರಿವು	AH R IH W UH
ಅರಿವೆಯ	AH R IH W EY Y
ಅರ್ಥ	AH R TH
ಅರ್ಥರ್ನ	AH R TH AH R N
ಅರ್ಥವನ್ನು	AH R TH AH W AH N N UH
ಅರ್ಧಗುಲಾಮರಾದ	AH R DH AH G UH L AA M AH R AA D
ಅಲ್ಲಲ್ಲಿ	AH L L AH L L IH
ಅಲ್ಲವೆಂದೇ	AH L L AH W EY N D AE
ಅಲ್ಲಿ	AH L L IH
ಅಳವಡಿಸುವ	AH L AH W AH D IH S UH W
ಅವತಾರವನ್ನು	AH W AH T AA R AH W AH N N UH
ಅವಧಿಯಲ್ಲಿ	AH W AH DH IH Y AH L L IH
ಅವನ	AH W AH N
ಅವನಿಗೆ	AH W AH N IH G EY
ಅವನು	AH W AH N UH
ಅವನ್ನು	AH W AH N N UH
ಅವರ	AH W AH R
ಅವರನ್ನು	AH W AH R AH N N UH
ಅವರಲ್ಲಿ	AH W AH R AH L L IH
ಅವರಿಗಿಂತ	AH W AH R IH G IH N T
ಅವರಿಗೆ	AH W AH R IH G EY
ಅವರು	AH W AH R UH
ಅವರೇ	AH W AH R AE
ಅವುಗಳು	AH W UH G AH L UH
ಅಶಾಕಿರಣವಾಗಿ	AH SH AA K IH R AH N AH W AA G IH
ಅಸ್ಪೃಶ್ಯ	AH S P R IH SH Y
ಅಹೋಬಲ	AH HH AO B AH L
ಅಹೋಬಲದೇವರನ್ನು	AH HH AO B AH L AH D AE W AH R AH N N UH
ಆ	AA
ಆಂದೋಳನ	AA N D AO L AH N
ಆಕ್ರಮಣವನ್ನು	AA K R AH M AH N AH W AH N N UH
ಆಗ	AA G
ಆಗಬೇಕಾದ	AA G AH B AE K AA D
ಆಗಮಿಸುವ	AA G AH M IH S UH W
ಆಗಲೂ	AA G AH L UW
ಆಗಿತ್ತು	AA G IH T T UH
ಆಗಿದೆಯೋ	AA G IH D EY Y AO
ಆಗಿರುವ	AA G IH R UH W
ಆಗಿಲ್ಲ	AA G IH L L
ಆಗುತ್ತದೆ	AA G UH T T AH D EY
ಆಚರಿಸುತ್ತಾರೆ	AA CH AH R IH S UH T T AA R EY
ಆಡಳಿತ	AA D AH L IH T
ಆಡುತ್ತಿದ್ದರೇನೋ	AA D UH T T IH D D AH R AE N AO
ಆತ್ಮಚರಿತ್ರೆಯಾಗಿದೆ	AA T M AH CH AH R IH T R EY Y AA G IH D EY
ಆದರೆ	AA D AH R EY
ಆದ್ದರಿಂದ	AA D D AH R IH N D
ಆನಂದವಿದೆ	AA N AH N D AH W IH D EY
ಆನುವಂಶಿಕ	AA N UH W AH N SH IH K
ಆಫ್ರಿಕಾದ	AA F R IH K AA D
ಆಯ್ಕೆ	AA Y K EY
ಆರಂಭವಾಗುತ್ತವೆ	AA R AH N B HH AH W AA G UH T T AH W EY
ಆರಂಭವಾಯಿತೆನ್ನಬಹುದು	AA R AH N B HH AH W AA Y IH T EY N N AH B AH HH UH D UH
ಆರಾಧನೆ	AA R AA DH AH N EY
ಆರಾಧಿಸಿದರೆ	AA R AA DH IH S IH D AH R EY
ಆರಾಧ್ಯ	AA R AA DH Y
ಆರ್ಥಿಕ	AA R TH IH K
ಆಲೋಚನೆಗಳು	AA L AO CH AH N EY G AH L UH
ಆಳಿದ	AA L IH D
ಆಹಾರವಿಲ್ಲದೆ	AA HH AA R AH W IH L L AH D EY
ಇಂತಹ	IH N T AH HH
ಇಂದು	IH N D UH
ಇಚ್ಚಿಸಿದಾಗ	IH CH CH IH S IH D AA G
ಇಟ್ಟಿಗೆಗಳನ್ನು	IH T T IH G EY G AH L AH N N UH
ಇಟ್ಟಿಗೆಗಳಿಗೆ	IH T T IH G EY G AH L IH G EY
ಇತರ	IH T AH R
ಇತ್ತು	IH T T UH
ಇತ್ಯಾದಿ	IH T Y AA D IH
ಇದಕ್ಕೆ	IH D AH K K EY
ಇದನ್ನರಿತ	IH D AH N N AH R IH T
ಇದರ	IH D AH R
ಇದರರ್ಥ	IH D AH R AH R TH
ಇದರಿಂದ	IH D AH R IH N D
ಇದರಿಂದಾಗಿ	IH D AH R IH N D AA G IH
ಇದು	IH D UH
ಇದೆ	IH D EY
ಇದೊಂದು	IH D OW N D UH
ಇದ್ದ	IH D D
ಇದ್ದಾಗ	IH D D AA G
ಇನ್ನಷ್ಟು	IH N N AH SH T UH
ಇನ್ನೂ	IH N N UW
ಇನ್ನೊಂದು	IH N N OW N D UH
ಇನ್ಸ್ಪೆಕ್ಟರ್	IH N S P EY K T AH R
ಇಪ್ಪತ್ತು	IH P P AH T T UH
ಇರುತ್ತದೆ	IH R UH T T AH D EY
ಇರುವಂಥದೇ	IH R UH W AH N TH AH D AE
ಇರುವುದನ್ನು	IH R UH W UH D AH N N UH
ಇರುವುದರಿಂದ	IH R UH W UH D AH R IH N D
ಇಲಾಖೆಯನ್ನು	IH L AA K HH EY Y AH N N UH
ಇಲ್ಲ	IH L L
ಇಲ್ಲಮ್ಮ	IH L L AH M M
ಇಲ್ಲಿ	IH L L IH
ಇಲ್ಲಿಂದ	IH L L IH N D
ಇಲ್ಲಿನ	IH L L IH N
ಇಲ್ಲಿರುವ	IH L L IH R UH W
ಇಳುವರಿ	IH L UH W AH R IH
ಇವನ	IH W AH N
ಇವನು	IH W AH N UH
ಇವರಿಗೆ	IH W AH R IH G EY
ಇವರು	IH W AH R UH
ಇವು	IH W UH
ಇವುಗಳ	IH W UH G AH L
ಇವುಗಳನ್ನು	IH W UH G AH L AH N N UH
ಇಸ್ಲಾಂ	IH S L AA N
ಇಸ್ಲಾಮರಿಗೆ	IH S L AA M AH R IH G EY
ಈ	IY
ಈಗ	IY G
ಈಜಿಪ್ಟಿನ	IY JH IH P T IH N
ಈತ	IY T
ಈತನ	IY T AH N
ಈತನಿಂದ	IY T AH N IH N D
ಉಕ್ಕಿಬಂತು	UH K K IH B AH N T UH
ಉಚಿತ	UH CH IH T
ಉಚ್ಚಂಗಿ	UH CH CH AH N G IH
ಉತ್ತಮ	UH T T AH M
ಉತ್ತರ	UH T T AH R
ಉತ್ತರದ	UH T T AH R AH D
ಉತ್ತರದಲ್ಲಿ	UH T T AH R AH D AH L L IH
ಉದಾರವಾದಿ	UH D AA R AH W AA D IH
ಉದಾಹರಣೆಗೆ	UH D AA HH AH R AH N EY G EY
ಉದ್ದೇಶ	UH D D AE SH
ಉದ್ದೇಶಕ್ಕಾಗಿ	UH D D AE SH AH K K AA G IH
ಉದ್ಭವಿಸಿದ	UH D B HH AH W IH S IH D
ಉಪಜಾತಿಗಳಿಂದ	UH P AH JH AA T IH G AH L IH N D
ಉಪಾವಾಸದಿಂದ	UH P AA W AA S AH D IH N D
ಉಲೇಮಾ	UH L AE M AA
ಉಳಿದವರನ್ನು	UH L IH D AH W AH R AH N N UH
ಊಟ	UW T
ಊಟೆಗಳಿದ್ದುದರಿಂದ	UW T EY G AH L IH D D UH D AH R IH N D
ಊದಿ	UW D IH
ಊರಿಗೆ	UW R IH G EY
ಊರಿನ	UW R IH N
ಋಷಿಯೊಬ್ಬನಿಗೆ	R IH SH IH Y OW B B AH N IH G EY
ಎಂದನು	EY N D AH N UH
ಎಂದರು	EY N D AH R UH
ಎಂದಲ್ಲ	EY N D AH L L
ಎಂದಾಗುತ್ತದೆ	EY N D AA G UH T T AH D EY
ಎಂದಿನಿಂದಲೂ	EY N D IH N IH N D AH L UW
ಎಂದು	EY N D UH
ಎಂದೆಲ್ಲಾ	EY N D EY L L AA
ಎಂಬ	EY N B
ಎಂಬುದನ್ನು	EY N B UH D AH N N UH
ಎಂಬುದು	EY N B UH D UH
ಎಡೆಕೊಡಬಾರದೆಂದು	EY D EY K OW D AH B AA R AH D EY N D UH
ಎತ್ತಿಕೊಂಡರೆ	EY T T IH K OW N D AH R EY
ಎತ್ತಿನಗಾಡಿಗಳನ್ನು	EY T T IH N AH G AA D IH G AH L AH N N UH
ಎದುರಿಸಿದ್ದನ್ನು	EY D UH R IH S IH D D AH N N UH
ಎನ್ನದೆ	EY N N AH D EY
ಎನ್ನುವ	EY N N UH W
ಎರಡನೆಯ	EY R AH D AH N EY Y
ಎರಡನೇ	EY R AH D AH N AE
ಎರಡು	EY R AH D UH
ಎರಡೂ	EY R AH D UW
ಎಲ್ಲ	EY L L
ಎಲ್ಲರಿಗೂ	EY L L AH R IH G UW
ಎಲ್ಲರೂ	EY L L AH R UW
ಏಕ	AE K
ಏಕೆಂದರೆ	AE K EY N D AH R EY
ಏನೆಲ್ಲ	AE N EY L L
ಏರಿಕೆ	AE R IH K EY
ಏರಿಸಲಾಯಿತು	AE R IH S AH L AA Y IH T UH
ಏಳನೆಯ	AE L AH N EY Y
ಏಸುಕ್ರಿಸ್ತನ	AE S UH K R IH S T AH N
ಒಂದು	OW N D UH
ಒಂದೇ	OW N D AE
ಒಂದೊಂದು	OW N D OW N D UH
ಒಟ್ಟಿನಲ್ಲಿ	OW T T IH N AH L L IH
ಒಡೆತನದಲ್ಲಿ	OW D EY T AH N AH D AH L L IH
ಒಡೆದುಕೊಂಡು	OW D EY D UH K OW N D UH
ಒಣಗಿಸಿದ	OW N AH G IH S IH D
ಒದಗಿಸಬೇಕಾಗಿತ್ತು	OW D AH G IH S AH B AE K AA G IH T T UH
ಒಬ್ಬ	OW B B
ಒಬ್ಬರು	OW B B AH R UH
ಒಯ್ಯುವರು	OW Y Y UH W AH R UH
ಒಳಪಡಿಸಿದಾಗ	OW L AH P AH D IH S IH D AA G
ಒಳ್ಳೆಯರು	OW L L EY Y AH R UH
ಓದುತ್ತಾರೆ	AO D UH T T AA R EY
ಕಂಡಿರುವುದು	K AH N D IH R UH W UH D UH
ಕಂಡು	K AH N D UH
ಕಂಬಳಿಹೊದ್ದು	K AH N B AH L IH HH OW D D UH
ಕಛೇರಿಯನ್ನು	K AH CH AE R IH Y AH N N UH
ಕಟ್ಟೆಮನೆಗಳ	K AH T T EY M AH N EY G AH L
ಕಡಿಮೆ	K AH D IH M EY
ಕಡಿಮೆಖಾಸಗೀಕರಣದ	K AH D IH M EY K HH AA S AH G IY K AH R AH N AH D
ಕಡೆಯಿಂದ	K AH D EY Y IH N D
ಕಣ್ಣಲ್ಲಿ	K AH N N AH L L IH
ಕಣ್ಣೆತ್ತಿ	K AH N N EY T T IH
ಕಣ್ಮನ	K AH N M AH N
ಕತೆಗಳ	K AH T EY G AH L
ಕಥೆಗಳನ್ನು	K AH TH EY G AH L AH N N UH
ಕಥೆಗಳಿಗೆ	K AH TH EY G AH L IH G EY
ಕನಿಷ್ಟವಾಗಿದೆ	K AH N IH SH T AH W AA G IH D EY
ಕನ್ನಡ	K AH N N AH D
ಕನ್ನಡದಲ್ಲಿ	K AH N N AH D AH D AH L L IH
ಕನ್ನಡಿಗರು	K AH N N AH D IH G AH R UH
ಕಪ್ಪಕಾಣಿಕೆಗಳನ್ನು	K AH P P AH K AA N IH K EY G AH L AH N N UH
ಕಪ್ಪು	K AH P P UH
ಕಮ್ಯುನಿಸ್ಟ್	K AH M Y UH N IH S T
ಕರಿಯರ	K AH R IH Y AH R
ಕರುಣದಿಂದ	K AH R UH N AH D IH N D
ಕರೆದುಕೊ	K AH R EY D UH K OW
ಕರೆದೊಯ್ಯುತ್ತೇನೆ	K AH R EY D OW Y Y UH T T AE N EY
ಕರೆಯಿಸಿದರು	K AH R EY Y IH S IH D AH R UH
ಕರೆಯುತ್ತಾರೆ	K AH R EY Y UH T T AA R EY
ಕರೆಯುತ್ತಿತ್ತು	K AH R EY Y UH T T IH T T UH
ಕರ್ನಾಟಕದ	K AH R N AA T AH K AH D
ಕರ್ಮಬಂಧನದಿಂದ	K AH R M AH B AH N DH AH N AH D IH N D
ಕಲಾವಂತರು	K AH L AA W AH N T AH R UH
ಕಲಾವಿದರಿಗೆ	K AH L AA W IH D AH R IH G EY
ಕಲಾವಿದರು	K AH L AA W IH D AH R UH
ಕಲಿಯುತ್ತಿರುವ	K AH L IH Y UH T T IH R UH W
ಕಲ್ಪನೆನಂಬಿಕೆಗಳನ್ನು	K AH L P AH N EY N AH N B IH K EY G AH L AH N N UH
ಕಲ್ಲಿನಲ್ಲಿರುವ	K AH L L IH N AH L L IH R UH W
ಕಳೆಂಜನು	K AH L EY N JH AH N UH
ಕಳೆಯನ್ನು	K AH L EY Y AH N N UH
ಕಷ್ಟ	K AH SH T
ಕಸ್ತೂರಿರಂಗಪ್ಪನಾಯಕ	K AH S T UW R IH R AH N G AH P P AH N AA Y AH K
ಕಾಂಗ್ರೆಸ್	K AA N G R EY S
ಕಾಗುಣಿತ	K AA G UH N IH T
ಕಾಟಪ್ಪನಹಟ್ಟಿಯ	K AA T AH P P AH N AH HH AH T T IH Y
ಕಾಡಿಗೆ	K AA D IH G EY
ಕಾಡಿತು	K AA D IH T UH
ಕಾಣಲು	K AA N AH L UH
ಕಾಣಿಸಿಕೊಳ್ಳುತ್ತದೆ	K AA N IH S IH K OW L L UH T T AH D EY
ಕಾಣುತ್ತಿದ್ದ	K AA N UH T T IH D D
ಕಾಣುತ್ತೇವೆ	K AA N UH T T AE W EY
ಕಾದಾಡಿಕೊಂಡು	K AA D AA D IH K OW N D UH
ಕಾನೂನುತಜ್ಞರನ್ನು	K AA N UW N UH T AH JH N AH R AH N N UH
ಕಾನೂನುಬಾಹಿರಗೊಳಿಸಿತು	K AA N UW N UH B AA HH IH R AH G OW L IH S IH T UH
ಕಾಮಗೇತಿಯನ್ನು	K AA M AH G AE T IH Y AH N N UH
ಕಾಯ್ದೆಕಾನೂನುಗಳ	K AA Y D EY K AA N UW N UH G AH L
ಕಾರಣದಿಂದಲೆ	K AA R AH N AH D IH N D AH L EY
ಕಾರಣವಾಗಿದೆ	K AA R AH N AH W AA G IH D EY
ಕಾರ್ಯ	K AA R Y
ಕಾರ್ಯಕ್ರಮದಲ್ಲಿ	K AA R Y AH K R AH M AH D AH L L IH
ಕಾರ್ಯವನ್ನೂ	K AA R Y AH W AH N N UW
ಕಾರ್ಯವಾಗಿದ್ದಿತೇ	K AA R Y AH W AA G IH D D IH T AE
ಕಾಲ	K AA L
ಕಾಲದಲ್ಲಿ	K AA L AH D AH L L IH
ಕಾಲದಲ್ಲಿದ್ದ	K AA L AH D AH L L IH D D
ಕಾಲಿರಿಸಿ	K AA L IH R IH S IH
ಕಾವ್ಯದ	K AA W Y AH D
ಕೀರ್ತಿ	K IY R T IH
ಕುಡಿಯಬೇಕೆಂದು	K UH D IH Y AH B AE K EY N D UH
ಕುತೂಹಲದಿಂದ	K UH T UW HH AH L AH D IH N D
ಕುಮಟಾ	K UH M AH T AA
ಕುರಿತು	K UH R IH T UH
ಕುರುಹುಗಳಿವೆ	K UH R UH HH UH G AH L IH W EY
ಕುಸಿಯುತ್ತಾ	K UH S IH Y UH T T AA
ಕೂಗಿದಾಗ	K UW G IH D AA G
ಕೂಡ	K UW D
ಕೂಡಿತ್ತು	K UW D IH T T UH
ಕೂರಲು	K UW R AH L UH
ಕೂರಿಸಿದ್ದಾರೆ	K UW R IH S IH D D AA R EY
ಕೃಷಿ	K R IH SH IH
ಕೃಷಿಗೆ	K R IH SH IH G EY
ಕೃಷಿಯ	K R IH SH IH Y
ಕೃಷಿಯೇತರ	K R IH SH IH Y AE T AH R
ಕೃಷ್ಣನಾಮ	K R IH SH N AH N AA M
ಕೆಂಗಲ್ಲರಿಗೆ	K EY N G AH L L AH R IH G EY
ಕೆಟ್ಟು	K EY T T UH
ಕೆಲವು	K EY L AH W UH
ಕೆಲಸ	K EY L AH S
ಕೆಲಸಗಾರರ	K EY L AH S AH G AA R AH R
ಕೆಳಕಂಡ	K EY L AH K AH N D
ಕೆಳಗಿನ	K EY L AH G IH N
ಕೇಂದ್ರಾಡಳಿತ	K AE N D R AA D AH L IH T
ಕೇಂದ್ರಿತ	K AE N D R IH T
ಕೇಂದ್ರೀಕೃತ	K AE N D R IY K R IH T
ಕೇಂದ್ರೀಕೃತವಾಯಿತು	K AE N D R IY K R IH T AH W AA Y IH T UH
ಕೇವಲ	K AE W AH L
ಕೈಗನ್ನಡಿಯಂತಿದೆ	K AH IH G AH N N AH D IH Y AH N T IH D EY
ಕೈಗಾರಿಕೆಗಳಿಗೆ	K AH IH G AA R IH K EY G AH L IH G EY
ಕೈಯಲ್ಲಿ	K AH IH Y AH L L IH
ಕೊಟ್ಟ	K OW T T
ಕೊಟ್ಟನು	K OW T T AH N UH
ಕೊಟ್ಟರೆ	K OW T T AH R EY
ಕೊಠಡಿಯುಳ್ಳ	K OW TH AH D IH Y UH L L
ಕೊಡುತ್ತಾನೆ	K OW D UH T T AA N EY
ಕೊಡುತ್ತಿದ್ದರು	K OW D UH T T IH D D AH R UH
ಕೊಮ್ಮೆ	K OW M M EY
ಕೊರತೆ	K OW R AH T EY
ಕೊರಳ	K OW R AH L
ಕೋಟಿ	K AO T IH
ಕೋಟೆಗೆರೆ	K AO T EY G EY R EY
ಕೋಣೆಯುಳ್ಳ	K AO N EY Y UH L L
ಕೋನಸಾಗರದ	K AO N AH S AA G AH R AH D
ಕೋರ್ಲಮಲ್ಲಿನಾಯಕನ	K AO R L AH M AH L L IH N AA Y AH K AH N
ಕೋಷ್ಟಕದಲ್ಲಿ	K AO SH T AH K AH D AH L L IH
ಕ್ಯೂಬಾದಲ್ಲಿ	K Y UW B AA D AH L L IH
ಕ್ರಮ	K R AH M
ಕ್ರಮಕ್ಕಿಂತ	K R AH M AH K K IH N T
ಕ್ರಾಂತಿಯು	K R AA N T IH Y UH
ಕ್ರಾಂತಿವೀರ	K R AA N T IH W IY R
ಕ್ರಿಯಾಶೀಲವಾಗಿದೆ	K R IH Y AA SH IY L AH W AA G IH D EY
ಕ್ರೈಸ್ತ	K R AH IH S T
ಕ್ಷಮಿಸು	K SH AH M IH S UH
ಕ್ಷೇತ್ರವೆನಿಸಿದೆ	K SH AE T R AH W EY N IH S IH D EY
ಖಚಿತವಾಗಿ	K HH AH CH IH T AH W AA G IH
ಖಾದಿ	K HH AA D IH
ಖಾಸಗಿ	K HH AA S AH G IH
ಗಂಗೆ	G AH N G EY
ಗಂಟೆಯ	G AH N T EY Y
ಗಂಡಸರ	G AH N D AH S AH R
ಗಂಡಾಂತರಗಳನ್ನು	G AH N D AA N T AH R AH G AH L AH N N UH
ಗಂಭೀರ	G AH N B HH IY R
ಗಣನೀಯ	G AH N AH N IY Y
ಗಮನವಿಡುತ್ತಿದ್ದರು	G AH M AH N AH W IH D UH T T IH D D AH R UH
ಗಮನಿಸಬಹುದು	G AH M AH N IH S AH B AH HH UH D UH
ಗಮನಿಸುತ್ತಿದ್ದರು	G AH M AH N IH S UH T T IH D D AH R UH
ಗಲಿಬಿಲಿ	G AH L IH B IH L IH
ಗಳಗಂಟಗಾದಶೆಟ್ಟಿಯನ್ನು	G AH L AH G AH N T AH G AA D AH SH EY T T IH Y AH N N UH
ಗಳನ್ನು	G AH L AH N N UH
ಗಳು	G AH L UH
ಗಹನವಾದದ್ದು	G AH HH AH N AH W AA D AH D D UH
ಗಾದರಿಪಾಲನಾಯಕ	G AA D AH R IH P AA L AH N AA Y AH K
ಗಾದರಿಪಾಲನಾಯಕನ	G AA D AH R IH P AA L AH N AA Y AH K AH N
ಗಾದೆ	G AA D EY
ಗುಂಪಿಗೂ	G UH N P IH G UW
ಗುಂಪಿನ	G UH N P IH N
ಗುಂಪಿನಲ್ಲಿ	G UH N P IH N AH L L IH
ಗುಟ್ಟಾಗಿ	G UH T T AA G IH
ಗುಡಿಯಲ್ಲಿ	G UH D IH Y AH L L IH
ಗುಡುಗಿದರು	G UH D UH G IH D AH R UH
ಗುಣಪಡಿಸುವವನು	G UH N AH P AH D IH S UH W AH W AH N UH
ಗುರಿ	G UH R IH
ಗುರುತಿಸದೆ	G UH R UH T IH S AH D EY
ಗುಲಬರ್ಗಾ	G UH L AH B AH R G AA
ಗುಲಾಮಗಿರಿ	G UH L AA M AH G IH R IH
ಗುಲಾಮಗಿರಿಗೆ	G UH L AA M AH G IH R IH G EY
ಗುಳಿ	G UH L IH
ಗೊತ್ತಿಲ್ಲ	G OW T T IH L L
ಗೊತ್ತು	G OW T T UH
ಗೊಳಿಸುವುದು	G OW L IH S UH W UH D UH
ಗೋಕುಲಾಷ್ಟಮಿ	G AO K UH L AA SH T AH M IH
ಗೋಪಾಲ	G AO P AA L
ಗೌತಮ	G AH OW T AH M
ಗೌರವ	G AH OW R AH W
ಗ್ರಂಥ	G R AH N TH
ಗ್ರಂಥಗಳಿಂದ	G R AH N TH AH G AH L IH N D
ಗ್ರಾಮೀಣ	G R AA M IY N
ಗ್ರೀಕ್	G R IY K
ಘಾನಾವನ್ನು	G HH AA N AA W AH N N UH
ಘೋಷಿಸಿದ	G HH AO SH IH S IH D
ಚರಿತ್ರೆ	CH AH R IH T R EY
ಚರಿತ್ರೆಕಾರ	CH AH R IH T R EY K AA R
ಚರಿತ್ರೆಯನ್ನು	CH AH R IH T R EY Y AH N N UH
ಚರಿತ್ರೆಯಲ್ಲಿ	CH AH R IH T R EY Y AH L L IH
ಚರ್ಚಿಸಲು	CH AH R CH IH S AH L UH
ಚರ್ಚಿಸಿದೆ	CH AH R CH IH S IH D EY
ಚರ್ಚಿಸಿರುವುದಕ್ಕೂ	CH AH R CH IH S IH R UH W UH D AH K K UW
ಚಲನೆಯನ್ನೂ	CH AH L AH N EY Y AH N N UW
ಚಳವಳಿಯನ್ನು	CH AH L AH W AH L IH Y AH N N UH
ಚಾರಿತ್ರಿಕ	CH AA R IH T R IH K
ಚಾಲುಕ್ಯರು	CH AA L UH K Y AH R UH
ಚಿಂತನೆಯ	CH IH N T AH N EY Y
ಚಿಕ್ಕಹಳ್ಳಿ	CH IH K K AH HH AH L L IH
ಚಿತ್ರಕೂಟವು	CH IH T R AH K UW T AH W UH
ಚಿನ್ನಪಲ್ಲಿನಾಯಕ	CH IH N N AH P AH L L IH N AA Y AH K
ಚಿಲುಮೆಯಲ್ಲಿ	CH IH L UH M EY Y AH L L IH
ಚುನಾವಣೆಯಲ್ಲಿ	CH UH N AA W AH N EY Y AH L L IH
ಚೆನ್ನಯದ	CH EY N N AH Y AH D
ಚೆನ್ನಾಗಿ	CH EY N N AA G IH
ಛಾವಣಿಯುಳ್ಳ	CH AA W AH N IH Y UH L L
ಜಗತ್ತಿನ	JH AH G AH T T IH N
ಜಗತ್ತೇ	JH AH G AH T T AE
ಜನ	JH AH N
ಜನತಂತ್ರಕ್ಕಾಗಿ	JH AH N AH T AH N T R AH K K AA G IH
ಜನತಾದಳಕ್ಕೆ	JH AH N AH T AA D AH L AH K K EY
ಜನತೆಗೆ	JH AH N AH T EY G EY
ಜನತೆಯ	JH AH N AH T EY Y
ಜನಪದ	JH AH N AH P AH D
ಜನರಲ್	JH AH N AH R AH L
ಜನರು	JH AH N AH R UH
ಜನಸಂಖ್ಯೆಗೆ	JH AH N AH S AH N K HH Y EY G EY
ಜನಸಾಮಾನ್ಯರಿಗೆ	JH AH N AH S AA M AA N Y AH R IH G EY
ಜನಾಂಗವನ್ನು	JH AH N AA N G AH W AH N N UH
ಜವಾಬ್ದಾರಿಯನ್ನು	JH AH W AA B D AA R IH Y AH N N UH
ಜವಾಬ್ದಾರಿಯಿದೆ	JH AH W AA B D AA R IH Y IH D EY
ಜಾಂತಾಗಡಿಗೆ	JH AA N T AA G AH D IH G EY
ಜಾಗತಿಕ	JH AA G AH T IH K
ಜಾತಿಭೇದವನ್ನಳಿಸಲು	JH AA T IH B HH AE D AH W AH N N AH L IH S AH L UH
ಜಿಲ್ಲೆಯ	JH IH L L EY Y
ಜಿಲ್ಲೆಯಲ್ಲಿ	JH IH L L EY Y AH L L IH
ಜೀವನ	JH IY W AH N
ಜೀವನದಲ್ಲಿ	JH IY W AH N AH D AH L L IH
ಜೀವನಮಟ್ಟ	JH IY W AH N AH M AH T T
ಜೊತೆ	JH OW T EY
ಜೊತೆಗೆ	JH OW T EY G EY
ಝರತುಷ್ಟ್ರಧರ್ಮವು	JH AH R AH T UH SH T R AH DH AH R M AH W UH
ಟಿವಿ	T IH W IH
ಡಂಬಾ	D AH N B AA
ಡಚ್ಚರು	D AH CH CH AH R UH
ಡೋಗನ್	D AO G AH N
ತಂತ್ರ	T AH N T R
ತಂದಿದ್ದರಂತೆ	T AH N D IH D D AH R AH N T EY
ತಂದು	T AH N D UH
ತಗಾದೆ	T AH G AA D EY
ತಡಮಾಡದೇ	T AH D AH M AA D AH D AE
ತಡೆಯಲಾಗಲಿಲ್ಲ	T AH D EY Y AH L AA G AH L IH L L
ತಣಿಸಿ	T AH N IH S IH
ತಣಿಸುತ್ತದೆ	T AH N IH S UH T T AH D EY
ತತ್ವಗಳು	T AH T W AH G AH L UH
ತತ್ವದ	T AH T W AH D
ತನ್ನ	T AH N N
ತನ್ನದೆನ್ನುವ	T AH N N AH D EY N N UH W
ತಪಸ್ಸು	T AH P AH S S UH
ತಪ್ಪು	T AH P P UH
ತಮಟೆಯ	T AH M AH T EY Y
ತಮ್ಮ	T AH M M
ತಮ್ಮನ್ನು	T AH M M AH N N UH
ತರಗತಿಯಲ್ಲಿ	T AH R AH G AH T IH Y AH L L IH
ತರವಲ್ಲ	T AH R AH W AH L L
ತರುವಾಯ	T AH R UH W AA Y
ತಳದಿಂದ	T AH L AH D IH N D
ತಳಿಗಳನ್ನು	T AH L IH G AH L AH N N UH
ತಾತ್ಕಾಲಿಕ	T AA T K AA L IH K
ತಾಮಸಶಕ್ತಿ	T AA M AH S AH SH AH K T IH
ತಾಲ್ಲೂಕಿನ	T AA L L UW K IH N
ತಾಳಿದ್ದನು	T AA L IH D D AH N UH
ತಾಳುತ್ತಾನೆ	T AA L UH T T AA N EY
ತಾವು	T AA W UH
ತಿನ್ನಲು	T IH N N AH L UH
ತಿನ್ನುವುದು	T IH N N UH W UH D UH
ತಿನ್ನುವುದೇ	T IH N N UH W UH D AE
ತಿಪ್ಪಯ್ಯ	T IH P P AH Y Y
ತಿಳಿದ	T IH L IH D
ತಿಳಿದಾಗ್ಯು	T IH L IH D AA G Y UH
ತಿಳಿದಿದ್ದರು	T IH L IH D IH D D AH R UH
ತಿಳಿದು	T IH L IH D UH
ತಿಳುವಳಿಕೆಯಲ್ಲಿ	T IH L UH W AH L IH K EY Y AH L L IH
ತೀರ್ಥದಿಂದ	T IY R TH AH D IH N D
ತೀರ್ಮಾನಗಳೆಂದರೆ	T IY R M AA N AH G AH L EY N D AH R EY
ತೀವ್ರವಾಗಿ	T IY W R AH W AA G IH
ತುಂಬಾ	T UH N B AA
ತುಂಬಿದುದು	T UH N B IH D UH D UH
ತುತ್ತಾಗಿ	T UH T T AA G IH
ತುಳು	T UH L UH
ತುಳುನಾಡಲಿದ್ದ	T UH L UH N AA D AH L IH D D
ತುಳುಭಾಷೆ	T UH L UH B HH AA SH EY
ತುಳುಭಾಷೆಯಲ್ಲೇ	T UH L UH B HH AA SH EY Y AH L L AE
ತುಳುವರು	T UH L UH W AH R UH
ತುಳುವಿನ	T UH L UH W IH N
ತುಳುವಿನಲ್ಲೇ	T UH L UH W IH N AH L L AE
ತೆಗೆದುಕೊಂಡ	T EY G EY D UH K OW N D
ತೆಗೆದುಕೊಂಡು	T EY G EY D UH K OW N D UH
ತೆಗೆಯಬಹುದು	T EY G EY Y AH B AH HH UH D UH
ತೆತ್ತ	T EY T T
ತೆರಿಗೆ	T EY R IH G EY
ತೇದಿಗಳನ್ನು	T AE D IH G AH L AH N N UH
ತೋರಿಸಿಕೊಟ್ಟವರು	T AO R IH S IH K OW T T AH W AH R UH
ಥೇಬ್ಸ್	TH AE B S
ದಂಡ	D AH N D
ದಕ್ಷತೆಲಾಭಬಂಡವಾಳ	D AH K SH AH T EY L AA B HH AH B AH N D AH W AA L
ದಕ್ಷಿಣ	D AH K SH IH N
ದಡದ	D AH D AH D
ದಡ್ಡಿ	D AH D D IH
ದನಕರುಗಳು	D AH N AH K AH R UH G AH L UH
ದಯನೀಯವಾದ	D AH Y AH N IY Y AH W AA D
ದರ್ಶನವಾಗುವುದು	D AH R SH AH N AH W AA G UH W UH D UH
ದಳಪತಿ	D AH L AH P AH T IH
ದಿನ	D IH N
ದಿವ್ಯಾತ್ಮನು	D IH W Y AA T M AH N UH
ದಿಶೆಯಲ್ಲಿ	D IH SH EY Y AH L L IH
ದೀಪಾವಳಿ	D IY P AA W AH L IH
ದೀರ್ಘ	D IY R G HH
ದುಗದಗಲಮ್ಮ	D UH G AH D AH G AH L AH M M
ದುಡಿಮೆಗಳನ್ನು	D UH D IH M EY G AH L AH N N UH
ದುರ್ಬಲರ	D UH R B AH L AH R
ದುರ್ಬಲವಾಗಿದ್ದು	D UH R B AH L AH W AA G IH D D UH
ದುಷ್ಠಶಕ್ತಿ	D UH SH TH AH SH AH K T IH
ದೂರದೃಷ್ಟಿಗೆ	D UW R AH D R IH SH T IH G EY
ದೂರಮಾಡಿ	D UW R AH M AA D IH
ದೃಶ್ಯಗಳಿಗೆ	D R IH SH Y AH G AH L IH G EY
ದೇವತೆಗಳ	D AE W AH T EY G AH L
ದೇವತೆಗಳನ್ನು	D AE W AH T EY G AH L AH N N UH
ದೇವತೆಯು	D AE W AH T EY Y UH
ದೇವರಾಗಿ	D AE W AH R AA G IH
ದೇವರಿಗೆ	D AE W AH R IH G EY
ದೇವರೆತ್ತುಗಳ	D AE W AH R EY T T UH G AH L
ದೇಶಕ್ಕೆ	D AE SH AH K K EY
ದೇಶಗಳಲ್ಲಿ	D AE SH AH G AH L AH L L IH
ದೇಶದ	D AE SH AH D
ದೈವಲೀಲೆ	D AH IH W AH L IY L EY
ದೊಡ್ಡ	D OW D D
ದೊಡ್ಡವರಿಲ್ಲ	D OW D D AH W AH R IH L L
ದೊಡ್ಡವರು	D OW D D AH W AH R UH
ದೊರೆ	D OW R EY
ದೌರ್ಬಲ್ಯದಿಂದ	D AH OW R B AH L Y AH D IH N D
ದ್ದನ್ನು	D D AH N N UH
ದ್ಯೋತಕವಾಗಿ	D Y AO T AH K AH W AA G IH
ದ್ವಾಪರ	D W AA P AH R
ದ್ವಿಭಾಷಿಕ	D W IH B HH AA SH IH K
ಧರಿಸಿ	DH AH R IH S IH
ಧರ್ಮ	DH AH R M
ಧರ್ಮದ	DH AH R M AH D
ಧಾರ್ಮಿಕ	DH AA R M IH K
ಧೋರಣೆಗಳು	DH AO R AH N EY G AH L UH
ಧ್ವನಿಯಾಗಿ	DH W AH N IH Y AA G IH
ನಂತರ	N AH N T AH R
ನಂತರದ	N AH N T AH R AH D
ನಂದರಾಜನು	N AH N D AH R AA JH AH N UH
ನಂಬಿದವರನ್ನು	N AH N B IH D AH W AH R AH N N UH
ನಗರಕ್ಕೆ	N AH G AH R AH K K EY
ನಗರಗಳು	N AH G AH R AH G AH L UH
ನಗರದ	N AH G AH R AH D
ನಗರವು	N AH G AH R AH W UH
ನಗರಿಯಾಗಿ	N AH G AH R IH Y AA G IH
ನಡೆದ	N AH D EY D
ನಡೆಸುವರು	N AH D EY S UH W AH R UH
ನದಿಯ	N AH D IH Y
ನದಿಯನ್ನು	N AH D IH Y AH N N UH
ನನಗೆ	N AH N AH G EY
ನನ್ನ	N AH N N
ನಮಸ್ಕರಿಸಿದನು	N AH M AH S K AH R IH S IH D AH N UH
ನಮಸ್ಕಾರಗಳನ್ನು	N AH M AH S K AA R AH G AH L AH N N UH
ನಮ್ಮ	N AH M M
ನರಸಿoಹನ	N AH R AH S IH HH AH N
ನರಸಿಂಹನನ್ನು	N AH R AH S IH N HH AH N AH N N UH
ನಾಗರಖಂಡದ	N AA G AH R AH K HH AH N D AH D
ನಾಟಕ	N AA T AH K
ನಾಟಕಕಾರನಿಗೆ	N AA T AH K AH K AA R AH N IH G EY
ನಾಟಕಗಳಲ್ಲಿ	N AA T AH K AH G AH L AH L L IH
ನಾನಾ	N AA N AA
ನಾನು	N AA N UH
ನಾಯಕ	N AA Y AH K
ನಾಯಕನು	N AA Y AH K AH N UH
ನಾಯಕರು	N AA Y AH K AH R UH
ನಾರಯಣಪ್ಪ	N AA R AH Y AH N AH P P
ನಾರಾಯಣ	N AA R AA Y AH N
ನಾಲೆಡ್ಜ್ನ	N AA L EY D JH N
ನಾವೀಗ	N AA W IY G
ನಾವು	N AA W UH
ನಾಸರ್	N AA S AH R
ನಿಜ	N IH JH
ನಿಜವಾದ	N IH JH AH W AA D
ನಿತ್ಯ	N IH T Y
ನಿದರ್ಶನವನ್ನು	N IH D AH R SH AH N AH W AH N N UH
ನಿಧಾನಗತಿಯ	N IH DH AA N AH G AH T IH Y
ನಿಮ್ಮ	N IH M M
ನಿರಂತರ	N IH R AH N T AH R
ನಿರಪರಾಧಿ	N IH R AH P AH R AA DH IH
ನಿರೂಪಣೆಯಲ್ಲಿ	N IH R UW P AH N EY Y AH L L IH
ನಿರ್ಣಯಿಸಬೇಕಾಗುತ್ತದೆ	N IH R N AH Y IH S AH B AE K AA G UH T T AH D EY
ನಿರ್ಣಯಿಸುತ್ತೇವೆ	N IH R N AH Y IH S UH T T AE W EY
ನಿರ್ದೇಶಕ	N IH R D AE SH AH K
ನಿರ್ಮಾಣ	N IH R M AA N
ನಿರ್ಮಾಣಗೊಂಡಿದ್ದರೂ	N IH R M AA N AH G OW N D IH D D AH R UW
ನಿರ್ವಹಿಸಿದ್ದಾರೆ	N IH R W AH HH IH S IH D D AA R EY
ನಿಲ್ಲಿಸಬೇಕಾಯಿತು	N IH L L IH S AH B AE K AA Y IH T UH
ನೀಡಲಾಗಿದೆ	N IY D AH L AA G IH D EY
ನೀಡಿದರು	N IY D IH D AH R UH
ನೀನು	N IY N UH
ನೀರು	N IY R UH
ನೀವು	N IY W UH
ನುಡಿಸುವಿಕೆಗೆ	N UH D IH S UH W IH K EY G EY
ನೂತನ	N UW T AH N
ನೆಂಪು	N EY N P UH
ನೆಟ್ಟಿ	N EY T T IH
ನೆನೆದು	N EY N EY D UH
ನೆಯಮಿಸಿಕೊಳ್ಳಲಾಯಿತು	N EY Y AH M IH S IH K OW L L AH L AA Y IH T UH
ನೆರವಾಗುವ	N EY R AH W AA G UH W
ನೆರವಾಗುವುದೇ	N EY R AH W AA G UH W UH D AE
ನೆರೆದ	N EY R EY D
ನೆಲವನ್ನು	N EY L AH W AH N N UH
ನೆಲೆಗಳನ್ನು	N EY L EY G AH L AH N N UH
ನೆಲೆಗಳಾಗಿ	N EY L EY G AH L AA G IH
ನೇಮಿಸಲ್ಪಟ್ಟವರು	N AE M IH S AH L P AH T T AH W AH R UH
ನೇರ	N AE R
ನೈಲ್	N AH IH L
ನೈಸರ್ಗಿಕ	N AH IH S AH R G IH K
ನೋಡದ	N AO D AH D
ನೋಡಬೇಕು	N AO D AH B AE K UH
ನೋಡಿಕೊಳ್ಳುವವನು	N AO D IH K OW L L UH W AH W AH N UH
ನೋಡಿದ	N AO D IH D
ನೋಡುವ	N AO D UH W
ನೋಡೋಣ	N AO D AO N
ನೌಕಾ	N AH OW K AA
ನ್ಯಾಯ	N Y AA Y
ನ್ಯಾಯವಿದ್ದರೆ	N Y AA Y AH W IH D D AH R EY
ನ್ಯೂನ್ಯತೆಗಳು	N Y UW N Y AH T EY G AH L UH
ಪಂಕ್ತಿಯ	P AH N K T IH Y
ಪಂಥವನ್ನು	P AH N TH AH W AH N N UH
ಪಕ್ಷ	P AH K SH
ಪಕ್ಷಗಳು	P AH K SH AH G AH L UH
ಪಕ್ಷವನ್ನು	P AH K SH AH W AH N N UH
ಪಟೇಲನಿರುತ್ತಾನೆ	P AH T AE L AH N IH R UH T T AA N EY
ಪಟ್ಟುಬೆರಗಾದರು	P AH T T UH B EY R AH G AA D AH R UH
ಪಡೆದುಕೊಂಡ	P AH D EY D UH K OW N D
ಪಡೆಯಲಾಗಿದೆ	P AH D EY Y AH L AA G IH D EY
ಪಣತೊಟ್ಟಿದ್ದ	P AH N AH T OW T T IH D D
ಪದಗಳಿಗೆ	P AH D AH G AH L IH G EY
ಪಯಣ	P AH Y AH N
ಪರಂಪರೆಯಿಂದ	P AH R AH N P AH R EY Y IH N D
ಪರಮಾತ್ಮನ	P AH R AH M AA T M AH N
ಪರಸ್ಪರ	P AH R AH S P AH R
ಪರಾಕ್ರಮ	P AH R AA K R AH M
ಪರಿಚಿತವಾಗಿರುವ	P AH R IH CH IH T AH W AA G IH R UH W
ಪರಿಣಾಮವಾಗಿ	P AH R IH N AA M AH W AA G IH
ಪರಿವರ್ತನೆಗೊಂಡಿವೆ	P AH R IH W AH R T AH N EY G OW N D IH W EY
ಪರಿವರ್ತಿಸುವ	P AH R IH W AH R T IH S UH W
ಪರೀಕ್ಷಿಸಲು	P AH R IY K SH IH S AH L UH
ಪವಿತ್ರ	P AH W IH T R
ಪಶುಗಳನ್ನು	P AH SH UH G AH L AH N N UH
ಪಶುಸಂಗೋಪನೆಯಲ್ಲಿ	P AH SH UH S AH N G AO P AH N EY Y AH L L IH
ಪಾಡ್ದನಗಳಿಂದ	P AA D D AH N AH G AH L IH N D
ಪಾಡ್ದನವನ್ನು	P AA D D AH N AH W AH N N UH
ಪಾತ್ರಗಳನ್ನು	P AA T R AH G AH L AH N N UH
ಪಾತ್ರವನ್ನು	P AA T R AH W AH N N UH
ಪಾದದಲ್ಲಿ	P AA D AH D AH L L IH
ಪಾಪನಾಯಕ	P AA P AH N AA Y AH K
ಪಾಪನಾಯಕನ	P AA P AH N AA Y AH K AH N
ಪಾರಂಪರ್ಯವಾಗಿ	P AA R AH N P AH R Y AH W AA G IH
ಪಿತೃಪಂಥದ	P IH T R IH P AH N TH AH D
ಪೀಳಿಗೆಯ	P IY L IH G EY Y
ಪುಟ್ಟ	P UH T T
ಪುನರಾಗಮನದ	P UH N AH R AA G AH M AH N AH D
ಪುನರಾಗಮನವನ್ನು	P UH N AH R AA G AH M AH N AH W AH N N UH
ಪುನಶ್ಚೇತನ	P UH N AH SH CH AE T AH N
ಪುರವಣಿಯನ್ನು	P UH R AH W AH N IH Y AH N N UH
ಪುರಾಣ	P UH R AA N
ಪುರಾತನ	P UH R AA T AH N
ಪುರೋಗಾಮಿ	P UH R AO G AA M IH
ಪುರೋಭಿವೃದ್ಧಿಗೆ	P UH R AO B HH IH W R IH D DH IH G EY
ಪುಸ್ತಕದಲ್ಲಿ	P UH S T AH K AH D AH L L IH
ಪೂಜಿಸಲು	P UW JH IH S AH L UH
ಪೂಜಿಸುವ	P UW JH IH S UH W
ಪೂಜಿಸುವರು	P UW JH IH S UH W AH R UH
ಪೂಜಿಸುವುದು	P UW JH IH S UH W UH D UH
ಪೂರಕವಾದ	P UW R AH K AH W AA D
ಪೂರ್ಣವಾಗಿರಲಿಲ್ಲ	P UW R N AH W AA G IH R AH L IH L L
ಪೂರ್ವದ	P UW R W AH D
ಪೂರ್ವಾಚಾರದ	P UW R W AA CH AA R AH D
ಪ್ಯಾರಿಸ್ನಲ್ಲಿ	P Y AA R IH S N AH L L IH
ಪ್ರಕಟಗೊಂಡರೆ	P R AH K AH T AH G OW N D AH R EY
ಪ್ರಕಾರ	P R AH K AA R
ಪ್ರಕಾರದ	P R AH K AA R AH D
ಪ್ರಕ್ರಿಯೆಗಳನ್ನು	P R AH K R IH Y EY G AH L AH N N UH
ಪ್ರಗತಿ	P R AH G AH T IH
ಪ್ರಚಾರದಲ್ಲಿ	P R AH CH AA R AH D AH L L IH
ಪ್ರಜಾಪ್ರಭುತ್ವ	P R AH JH AA P R AH B HH UH T W
ಪ್ರಜಾಪ್ರಭುತ್ವದ	P R AH JH AA P R AH B HH UH T W AH D
ಪ್ರಜ್ವಲಗೊಳಿಸಿಕೊಳ್ಳಲು	P R AH JH W AH L AH G OW L IH S IH K OW L L AH L UH
ಪ್ರತಿ	P R AH T IH
ಪ್ರತಿಕ್ರಿಯೆಗಳ	P R AH T IH K R IH Y EY G AH L
ಪ್ರತಿಜ್ಞೆಯನ್ನು	P R AH T IH JH N EY Y AH N N UH
ಪ್ರತಿಪಾದಕನೆಂಬ	P R AH T IH P AA D AH K AH N EY N B
ಪ್ರತಿಭೆಗಳನ್ನು	P R AH T IH B HH EY G AH L AH N N UH
ಪ್ರತಿವರ್ಷ	P R AH T IH W AH R SH
ಪ್ರಥಮ	P R AH TH AH M
ಪ್ರದೇಶಗಳಲ್ಲೂ	P R AH D AE SH AH G AH L AH L L UW
ಪ್ರದೇಶಗಳಿಂದ	P R AH D AE SH AH G AH L IH N D
ಪ್ರಪಂಚದಲ್ಲಿ	P R AH P AH N CH AH D AH L L IH
ಪ್ರಬಲರಿಂದ	P R AH B AH L AH R IH N D
ಪ್ರಭಾಕರ	P R AH B HH AA K AH R
ಪ್ರಮುಖ	P R AH M UH K HH
ಪ್ರಮುಖವಾಗಿತ್ತು	P R AH M UH K HH AH W AA G IH T T UH
ಪ್ರಮೇಯಕ್ಕೆ	P R AH M AE Y AH K K EY
ಪ್ರಯತ್ನಗಳಿಂದಾಗಿ	P R AH Y AH T N AH G AH L IH N D AA G IH
ಪ್ರಯತ್ನವಾಗಿದೆ	P R AH Y AH T N AH W AA G IH D EY
ಪ್ರಯತ್ನಿಸಿವೆ	P R AH Y AH T N IH S IH W EY
ಪ್ರಯೋಗ	P R AH Y AO G
ಪ್ರಯೋಗವನ್ನು	P R AH Y AO G AH W AH N N UH
ಪ್ರಸಾರದ	P R AH S AA R AH D
ಪ್ರಸಿದ್ಧನಾದ	P R AH S IH D DH AH N AA D
ಪ್ರಸಿದ್ಧವಾಗಿದೆ	P R AH S IH D DH AH W AA G IH D EY
ಪ್ರಾಂತ್ಯಗಳನ್ನು	P R AA N T Y AH G AH L AH N N UH
ಪ್ರಾಚೀನ	P R AA CH IY N
ಪ್ರಾರಂಭದಲ್ಲಿ	P R AA R AH N B HH AH D AH L L IH
ಪ್ರಾರಂಭವನ್ನು	P R AA R AH N B HH AH W AH N N UH
ಪ್ರಾರಂಭವಾಯಿತು	P R AA R AH N B HH AH W AA Y IH T UH
ಪ್ರೀತಿಗಳ	P R IY T IH G AH L
ಪ್ರೆಸಿಡೆನ್ಸಿಯನ್ನು	P R EY S IH D EY N S IH Y AH N N UH
ಪ್ರೇತವೆಂದು	P R AE T AH W EY N D UH
ಫಣಿಯಪ್ಪನಿಗೆ	F AH N IH Y AH P P AH N IH G EY
ಫಲ	F AH L
ಫ್ರಾನ್ಸಿನಲ್ಲಿದ್ದ	F R AA N S IH N AH L L IH D D
ಫ್ರೆಂಚ್	F R EY N CH
ಬಂಗರ	B AH N G AH R
ಬಂಟ	B AH N T
ಬಂಡವಾಳಶಾಹಿಗಳು	B AH N D AH W AA L AH SH AA HH IH G AH L UH
ಬಂಡಾಯದ	B AH N D AA Y AH D
ಬಂದನು	B AH N D AH N UH
ಬಂದರು	B AH N D AH R UH
ಬಂದಾಗ	B AH N D AA G
ಬಂದಿದ್ದಾನೆ	B AH N D IH D D AA N EY
ಬಂದಿದ್ದಾಳೆ	B AH N D IH D D AA L EY
ಬಗೆಗೆ	B AH G EY G EY
ಬಟ್ಟೆ	B AH T T EY
ಬಡಗಿನವರೂ	B AH D AH G IH N AH W AH R UW
ಬಡತನದ	B AH D AH T AH N AH D
ಬದಲಾಗಲಿಲ್ಲ	B AH D AH L AA G AH L IH L L
ಬದಲಾಗಿ	B AH D AH L AA G IH
ಬದಲಾವಣೆ	B AH D AH L AA W AH N EY
ಬದುಕಿಗೆ	B AH D UH K IH G EY
ಬದುಕಿನ	B AH D UH K IH N
ಬದ್ಧವಾದ	B AH D DH AH W AA D
ಬಯಸುತ್ತಿದ್ದನು	B AH Y AH S UH T T IH D D AH N UH
ಬರಖಾಸ್ತುಗೊಳಿಸುವುದು	B AH R AH K HH AA S T UH G OW L IH S UH W UH D UH
ಬರಗಾಲಕ್ಕೆ	B AH R AH G AA L AH K K EY
ಬರಲಿಲ್ಲವೆಂದರೆ	B AH R AH L IH L L AH W EY N D AH R EY
ಬರುತ್ತದೆಯೇ	B AH R UH T T AH D EY Y AE
ಬರುತ್ತವೆ	B AH R UH T T AH W EY
ಬರುತ್ತಾಳೆ	B AH R UH T T AA L EY
ಬರುತ್ತಿತ್ತು	B AH R UH T T IH T T UH
ಬರುತ್ತಿದ್ದಾರೆ	B AH R UH T T IH D D AA R EY
ಬರುವ	B AH R UH W
ಬರೆಯುವ	B AH R EY Y UH W
ಬಲಿಷ್ಠರಾದ	B AH L IH SH TH AH R AA D
ಬಳಕೆಯಾದಂತೆ	B AH L AH K EY Y AA D AH N T EY
ಬಳಸಿಕೊಂಡರು	B AH L AH S IH K OW N D AH R UH
ಬಳಸಿಕೊಳ್ಳಲಾಯಿತು	B AH L AH S IH K OW L L AH L AA Y IH T UH
ಬಳಸಿದರು	B AH L AH S IH D AH R UH
ಬಳಸುತ್ತಾರೆ	B AH L AH S UH T T AA R EY
ಬಳಿಕ	B AH L IH K
ಬಳ್ಳಿ	B AH L L IH
ಬಸವಣ್ಣ	B AH S AH W AH N N
ಬಹಳ	B AH HH AH L
ಬಹುಪಾಲು	B AH HH UH P AA L UH
ಬಹುಮಂದಿ	B AH HH UH M AH N D IH
ಬಹುಶಃ	B AH HH UH SH AH HH
ಬಾಂಬೆ	B AA N B EY
ಬಾಗಾಗಳು	B AA G AA G AH L UH
ಬಾರದು	B AA R AH D UH
ಬಾರಿ	B AA R IH
ಬಾಲಕ	B AA L AH K
ಬಾಲಕನ	B AA L AH K AH N
ಬಾಲಕನೊಂದಿಗೆ	B AA L AH K AH N OW N D IH G EY
ಬಿಟ್ಟರೆ	B IH T T AH R EY
ಬಿಟ್ಟು	B IH T T UH
ಬಿಟ್ಟುಕೊಡಬೇಕಾಯಿತು	B IH T T UH K OW D AH B AE K AA Y IH T UH
ಬಿಟ್ಟುಹೋಗಿದ್ದಾರೆ	B IH T T UH HH AO G IH D D AA R EY
ಬಿದಿರೆ	B IH D IH R EY
ಬಿಳಿನೀರ	B IH L IH N IY R
ಬುಡಕಟ್ಟುಗಳಲ್ಲಿ	B UH D AH K AH T T UH G AH L AH L L IH
ಬುದ್ಧನೆಂಬುದರಲ್ಲಿ	B UH D DH AH N EY N B UH D AH R AH L L IH
ಬೂಸಾ	B UW S AA
ಬೃಹದಾಕಾರದ	B R IH HH AH D AA K AA R AH D
ಬೆಂಗಳೂರು	B EY N G AH L UW R UH
ಬೆಂಬಲ	B EY N B AH L
ಬೆರಗುಗೊಳ್ಳುವಂತೆ	B EY R AH G UH G OW L L UH W AH N T EY
ಬೆಲೆ	B EY L EY
ಬೆಳಕಿನಲ್ಲಿ	B EY L AH K IH N AH L L IH
ಬೆಳದಿಂಗಳಲ್ಲಿ	B EY L AH D IH N G AH L AH L L IH
ಬೆಳವಣಿಗೆ	B EY L AH W AH N IH G EY
ಬೆಳವಣಿಗೆಯ	B EY L AH W AH N IH G EY Y
ಬೆಳವಣಿಗೆಯನ್ನು	B EY L AH W AH N IH G EY Y AH N N UH
ಬೆಳವಣಿಗೆಯಿಂದಾಗಿ	B EY L AH W AH N IH G EY Y IH N D AA G IH
ಬೆಳೆದವು	B EY L EY D AH W UH
ಬೆಳೆಯಲಾರಂಭಿಸಿತು	B EY L EY Y AH L AA R AH N B HH IH S IH T UH
ಬೇಕು	B AE K UH
ಬೇಕೇ	B AE K AE
ಬೇಡರಿಗೆ	B AE D AH R IH G EY
ಬೇಡಿಕೊಂಡ	B AE D IH K OW N D
ಬೇಯಿಸಿದ	B AE Y IH S IH D
ಬೇರೂರಿದ್ದವು	B AE R UW R IH D D AH W UH
ಬೇರೆ	B AE R EY
ಬೇರೆಯಾಗಿರುತ್ತದೆ	B AE R EY Y AA G IH R UH T T AH D EY
ಬೇರೊಂದು	B AE R OW N D UH
ಬೇಸಿಗೆಯ	B AE S IH G EY Y
ಬೊಲ್ಶೆವಿಕ್	B OW L SH EY W IH K
ಬೋರ್ನುಗಳಂತಹ	B AO R N UH G AH L AH N T AH HH
ಬೌದ್ಧಧರ್ಮದ	B AH OW D DH AH DH AH R M AH D
ಬ್ರಾಹ್ಮಣರು	B R AA HH M AH N AH R UH
ಭಟ್ವೈದಿಕ	B HH AH T W AH IH D IH K
ಭಯೋತ್ಪಾದಕರು	B HH AH Y AO T P AA D AH K AH R UH
ಭಾಗಕ್ಕೆ	B HH AA G AH K K EY
ಭಾಗವಹಿಸುತ್ತಾರೆ	B HH AA G AH W AH HH IH S UH T T AA R EY
ಭಾಗವಾಗಿ	B HH AA G AH W AA G IH
ಭಾಗವೆಂದೇ	B HH AA G AH W EY N D AE
ಭಾಗಶಃ	B HH AA G AH SH AH HH
ಭಾರಿ	B HH AA R IH
ಭಾವನಾತ್ಮಕ	B HH AA W AH N AA T M AH K
ಭಾವಿಸಲಾಗಿದೆ	B HH AA W IH S AH L AA G IH D EY
ಭಾಷೆಯನ್ನು	B HH AA SH EY Y AH N N UH
ಭಿನ್ನ	B HH IH N N
ಭಿನ್ನವಾದ	B HH IH N N AH W AA D
ಭಿನ್ನಾಭಿಪ್ರಾಯ	B HH IH N N AA B HH IH P R AA Y
ಭೀಮಸೇನರಲ್ಲಿ	B HH IY M AH S AE N AH R AH L L IH
ಭೂತ	B HH UW T
ಭೂತಗಳಿಗೆ	B HH UW T AH G AH L IH G EY
ಮಂಗಳೂರಿಗೆ	M AH N G AH L UW R IH G EY
ಮಂಗಳೂರಿನ	M AH N G AH L UW R IH N
ಮಂಜಪ್ಪನವರು	M AH N JH AH P P AH N AH W AH R UH
ಮಂಟ್ಜರ್	M AH N T JH AH R
ಮಂಡಲಿಯನ್ನು	M AH N D AH L IH Y AH N N UH
ಮಂಡಲಿಯಲ್ಲಿದ್ದರು	M AH N D AH L IH Y AH L L IH D D AH R UH
ಮಂಡಳಿಗಳಾದ	M AH N D AH L IH G AH L AA D
ಮಂತ್ರಿಮಂಡಲವು	M AH N T R IH M AH N D AH L AH W UH
ಮಂದಿರಗಳು	M AH N D IH R AH G AH L UH
ಮಕ್ಕಳ	M AH K K AH L
ಮಕ್ಕಳನ್ನು	M AH K K AH L AH N N UH
ಮಗುವನ್ನು	M AH G UH W AH N N UH
ಮಡಿವಂತನೆಂಬ	M AH D IH W AH N T AH N EY N B
ಮತ್ತಷ್ಟು	M AH T T AH SH T UH
ಮತ್ತು	M AH T T UH
ಮತ್ತೆ	M AH T T EY
ಮತ್ತೊಬ್ಬರು	M AH T T OW B B AH R UH
ಮದಪ್ಪಂದಿ	M AH D AH P P AH N D IH
ಮದುವೆ	M AH D UH W EY
ಮಧುರೆಯಿಂದ	M AH DH UH R EY Y IH N D
ಮಧ್ಯಮ	M AH DH Y AH M
ಮನೆ	M AH N EY
ಮನೆಗಳು	M AH N EY G AH L UH
ಮನೆತನದವರು	M AH N EY T AH N AH D AH W AH R UH
ಮನೆಮಾಡಿದ್ದಂತೆಯೇ	M AH N EY M AA D IH D D AH N T EY Y AE
ಮನೆಯಲ್ಲಿ	M AH N EY Y AH L L IH
ಮಳೆಯ	M AH L EY Y
ಮಹತ್ತರವಾದ	M AH HH AH T T AH R AH W AA D
ಮಹತ್ವ	M AH HH AH T W
ಮಹತ್ವವನ್ನು	M AH HH AH T W AH W AH N N UH
ಮಹಾ	M AH HH AA
ಮಹಾಂತೇಶ್ವರನೆಂದು	M AH HH AA N T AE SH W AH R AH N EY N D UH
ಮಹಾದೇವಿಯ	M AH HH AA D AE W IH Y
ಮಹಾಪತಿವ್ರತೆಯಾದ	M AH HH AA P AH T IH W R AH T EY Y AA D
ಮಾಡಲಾಗುತ್ತಿರಲಿಲ್ಲ	M AA D AH L AA G UH T T IH R AH L IH L L
ಮಾಡಲಾಯ್ತು	M AA D AH L AA Y T UH
ಮಾಡಲಿಲ್ಲ	M AA D AH L IH L L
ಮಾಡಲು	M AA D AH L UH
ಮಾಡಿ	M AA D IH
ಮಾಡಿಕೊಂಡ	M AA D IH K OW N D
ಮಾಡಿಕೊಳ್ಳುತ್ತಾರೆ	M AA D IH K OW L L UH T T AA R EY
ಮಾಡಿಕೊಳ್ಳುವೆ	M AA D IH K OW L L UH W EY
ಮಾಡಿತು	M AA D IH T UH
ಮಾಡಿದರು	M AA D IH D AH R UH
ಮಾಡಿದರೂ	M AA D IH D AH R UW
ಮಾಡಿದವು	M AA D IH D AH W UH
ಮಾಡಿದ್ದ	M AA D IH D D
ಮಾಡುತ್ತದೆ	M AA D UH T T AH D EY
ಮಾಡುತ್ತಾರೆ	M AA D UH T T AA R EY
ಮಾಡುವವರು	M AA D UH W AH W AH R UH
ಮಾಡುವುದುಂಟು	M AA D UH W UH D UH N T UH
ಮಾತನಾಡುತ್ತಾ	M AA T AH N AA D UH T T AA
ಮಾತಾಡುವ	M AA T AA D UH W
ಮಾತಿಗೆ	M AA T IH G EY
ಮಾತು	M AA T UH
ಮಾತುಗಳನ್ನು	M AA T UH G AH L AH N N UH
ಮಾತ್ರ	M AA T R
ಮಾಧ್ಯಮ	M AA DH Y AH M
ಮಾಧ್ಯಮವು	M AA DH Y AH M AH W UH
ಮಾನವನನ್ನು	M AA N AH W AH N AH N N UH
ಮಾರಮ್ಮ	M AA R AH M M
ಮಾಲಿ	M AA L IH
ಮಾಹಿತಿ	M AA HH IH T IH
ಮಿತ್ರೇಯಿಸಂ	M IH T R AE Y IH S AH N
ಮೀರಿ	M IY R IH
ಮುಂತಾದ	M UH N T AA D
ಮುಂದುವರಿಯಿತು	M UH N D UH W AH R IH Y IH T UH
ಮುಂದೆ	M UH N D EY
ಮುಂಬೈಯಲ್ಲೂ	M UH N B AH IH Y AH L L UW
ಮುಕ್ತಗೊಳಿಸುವ	M UH K T AH G OW L IH S UH W
ಮುಕ್ತನಾದ	M UH K T AH N AA D
ಮುಕ್ತಮಾಡಿ	M UH K T AH M AA D IH
ಮುಖವಾಡಗಳಿಗೆ	M UH K HH AH W AA D AH G AH L IH G EY
ಮುಗಿದು	M UH G IH D UH
ಮುದ್ರಿತ	M UH D R IH T
ಮುಸಲ್ಮಾನ	M UH S AH L M AA N
ಮೂಗನಾಯಕನೆಂಬ	M UW G AH N AA Y AH K AH N EY N B
ಮೂಡಿದ್ದಾನೆ	M UW D IH D D AA N EY
ಮೂರನೇ	M UW R AH N AE
ಮೂರು	M UW R UH
ಮೂಲಕ	M UW L AH K
ಮೆಸಪಟೋಮಿಯವನ್ನು	M EY S AH P AH T AO M IH Y AH W AH N N UH
ಮೇಲಿರುವನೆಂದು	M AE L IH R UH W AH N EY N D UH
ಮೇಲೂ	M AE L UW
ಮೇಲೆ	M AE L EY
ಮೈತ್ರಿ	M AH IH T R IH
ಮೈಸೂರು	M AH IH S UW R UH
ಮೊದಲಾದವರು	M OW D AH L AA D AH W AH R UH
ಮೊದಲು	M OW D AH L UH
ಮೊದಲೇ	M OW D AH L AE
ಮೊಸರನ್ನೂ	M OW S AH R AH N N UW
ಮೋಜಿನ	M AO JH IH N
ಮೋಸ	M AO S
ಮೌಖಿಕ	M AH OW K HH IH K
ಯಜಮಾನನ	Y AH JH AH M AA N AH N
ಯಜಮಾನರ	Y AH JH AH M AA N AH R
ಯಜಮಾನ್	Y AH JH AH M AA N
ಯತ್ನಗಳು	Y AH T N AH G AH L UH
ಯಶಸ್ವಿಯಾಯಿತು	Y AH SH AH S W IH Y AA Y IH T UH
ಯಾವ	Y AA W
ಯಾವನೋ	Y AA W AH N AO
ಯಾವುದೇ	Y AA W UH D AE
ಯುಗದಲ್ಲಿ	Y UH G AH D AH L L IH
ಯುರೋಪ್	Y UH R AO P
ಯೆಲ್ಸಿನ್	Y EY L S IH N
ರಂಗಸಂಯೋಜನೆ	R AH N G AH S AH N Y AO JH AH N EY
ರಕ್ಷಿಸಿದ	R AH K SH IH S IH D
ರಕ್ಷಿಸುತ್ತಿತ್ತು	R AH K SH IH S UH T T IH T T UH
ರಕ್ಷಿಸುವ	R AH K SH IH S UH W
ರಕ್ಷಿಸುವುದು	R AH K SH IH S UH W UH D UH
ರಚಿಸಿದನು	R AH CH IH S IH D AH N UH
ರಾ	R AA
ರಾಖಿ	R AA K HH IH
ರಾಗಿಯಿಂದ	R AA G IH Y IH N D
ರಾಜ	R AA JH
ರಾಜಕಾರಣದಲ್ಲಿ	R AA JH AH K AA R AH N AH D AH L L IH
ರಾಜಕೀಯ	R AA JH AH K IY Y
ರಾಜನೇ	R AA JH AH N AE
ರಾಜಮನೆತನದಂತೆ	R AA JH AH M AH N EY T AH N AH D AH N T EY
ರಾಜರಿಗೆ	R AA JH AH R IH G EY
ರಾಜ್ಯ	R AA JH Y
ರಾಜ್ಯಕ್ಕೆ	R AA JH Y AH K K EY
ರಾಜ್ಯಗಳ	R AA JH Y AH G AH L
ರಾಜ್ಯಗಳಲ್ಲೂ	R AA JH Y AH G AH L AH L L UW
ರಾಜ್ಯಗಳು	R AA JH Y AH G AH L UH
ರಾಜ್ಯದ	R AA JH Y AH D
ರಾಜ್ಯದಲ್ಲಿ	R AA JH Y AH D AH L L IH
ರಾಜ್ಯವು	R AA JH Y AH W UH
ರಾಜ್ಯವೆಂದರೆ	R AA JH Y AH W EY N D AH R EY
ರಾತ್ರಿಗಳಲ್ಲಿ	R AA T R IH G AH L AH L L IH
ರಾಯಣ್ಣ	R AA Y AH N N
ರಾಯದುರ್ಗದಲ್ಲಿರುವ	R AA Y AH D UH R G AH D AH L L IH R UH W
ರಾಯಭಾರಿ	R AA Y AH B HH AA R IH
ರಾಯರು	R AA Y AH R UH
ರಾಷ್ಟ್ರತ್ವಗಳು	R AA SH T R AH T W AH G AH L UH
ರಾಷ್ಟ್ರವೀರ	R AA SH T R AH W IY R
ರಾಷ್ಟ್ರಿಯ	R AA SH T R IH Y
ರಾಷ್ಟ್ರೀಯ	R AA SH T R IY Y
ರಿಯಾಯಿತಿಗಳು	R IH Y AA Y IH T IH G AH L UH
ರೀತಿ	R IY T IH
ರೀತಿಯಲ್ಲೇ	R IY T IH Y AH L L AE
ರೂಪದಲ್ಲಿ	R UW P AH D AH L L IH
ರೂಪಿಸಿ	R UW P IH S IH
ರೂಪುಗೊಂಡಿತು	R UW P UH G OW N D IH T UH
ರೂಪುಗೊಂಡಿರಲಿಲ್ಲ	R UW P UH G OW N D IH R AH L IH L L
ರೂಪುಗೊಳ್ಳಲು	R UW P UH G OW L L AH L UH
ರೈತರು	R AH IH T AH R UH
ರೈಯವರ	R AH IH Y AH W AH R
ರೊಪ್ಪಕ್ಕೆ	R OW P P AH K K EY
ರೋಗರುಜಿನ	R AO G AH R UH JH IH N
ರೋಮನ್	R AO M AH N
ಲಂಚ	L AH N CH
ಲಕ್ಷಗಟ್ಟಲೇ	L AH K SH AH G AH T T AH L AE
ಲಕ್ಷ್ಮಣ	L AH K SH M AH N
ಲಭಿಸುತ್ತದೆ	L AH B HH IH S UH T T AH D EY
ಲೋಪ	L AO P
ವಂಚನೆಯ	W AH N CH AH N EY Y
ವಂಶ	W AH N SH
ವಂಶದ	W AH N SH AH D
ವಂಶವೃಕ್ಷದಲ್ಲಿ	W AH N SH AH W R IH K SH AH D AH L L IH
ವಂಶಸ್ಥರು	W AH N SH AH S TH AH R UH
ವರೆಗೂ	W AH R EY G UW
ವರ್ಗದಲ್ಲಿ	W AH R G AH D AH L L IH
ವರ್ಣಿಸಲು	W AH R N IH S AH L UH
ವರ್ಷಗಳ	W AH R SH AH G AH L
ವಲಯವನ್ನಾಗಿ	W AH L AH Y AH W AH N N AA G IH
ವಲಸೆ	W AH L AH S EY
ವಸೂಲಿ	W AH S UW L IH
ವಸ್ತು	W AH S T UH
ವಹಿಸಿತ್ತು	W AH HH IH S IH T T UH
ವಾಡೆಗೊಬ್ಬ	W AA D EY G OW B B
ವಾಣಿಜ್ಯ	W AA N IH JH Y
ವಾದಿಗಳನ್ನು	W AA D IH G AH L AH N N UH
ವಾಸಿಸುವುದು	W AA S IH S UH W UH D UH
ವಿಂಗಡಿಸಬಹುದು	W IH N G AH D IH S AH B AH HH UH D UH
ವಿಕೃತಿಗಳಿಗೆ	W IH K R IH T IH G AH L IH G EY
ವಿಗ್ರಹವನ್ನು	W IH G R AH HH AH W AH N N UH
ವಿಘಟನಕಾರೀ	W IH G HH AH T AH N AH K AA R IY
ವಿಚಿತ್ರ	W IH CH IH T R
ವಿಜಯಗೃಹದೊಳಗೆ	W IH JH AH Y AH G R IH HH AH D OW L AH G EY
ವಿದೇಶಿ	W IH D AE SH IH
ವಿದೇಶಿಯರ	W IH D AE SH IH Y AH R
ವಿದ್ಯಾರ್ಥಿಗಳನ್ನು	W IH D Y AA R TH IH G AH L AH N N UH
ವಿದ್ವಾಂಸರುಗಳು	W IH D W AA N S AH R UH G AH L UH
ವಿಧಾನಕ್ಕೆ	W IH DH AA N AH K K EY
ವಿಧಾನದ	W IH DH AA N AH D
ವಿಧೇಯರಾಗಿರುವುದು	W IH DH AE Y AH R AA G IH R UH W UH D UH
ವಿಭಾಗಗಳಾಗಿ	W IH B HH AA G AH G AH L AA G IH
ವಿಭಾಗದ	W IH B HH AA G AH D
ವಿಭಾಗದಲ್ಲಿ	W IH B HH AA G AH D AH L L IH
ವಿರುದ್ಧವೇ	W IH R UH D DH AH W AE
ವಿರೋಧಗಳು	W IH R AO DH AH G AH L UH
ವಿರೋಧಿಗಳು	W IH R AO DH IH G AH L UH
ವಿರೋಧಿಸಿದರು	W IH R AO DH IH S IH D AH R UH
ವಿವರವಾಗಿ	W IH W AH R AH W AA G IH
ವಿವರಿಸಬೇಕಾಗಿದೆ	W IH W AH R IH S AH B AE K AA G IH D EY
ವಿವಿಧ	W IH W IH DH
ವಿಶ್ವಪ್ರಜ್ಞೆಯಾಗಿ	W IH SH W AH P R AH JH N EY Y AA G IH
ವಿಷಯ	W IH SH AH Y
ವಿಷಯದಲ್ಲಿ	W IH SH AH Y AH D AH L L IH
ವಿಸ್ತಾರವಾಗಿ	W IH S T AA R AH W AA G IH
ವೀರ	W IY R
ವೀರಶೂರಧೀರ	W IY R AH SH UW R AH DH IY R
ವೀರಶೈವ	W IY R AH SH AH IH W
ವೀರಶೈವವೇ	W IY R AH SH AH IH W AH W AE
ವೃದ್ದಿಯಾಯಿತು	W R IH D D IH Y AA Y IH T UH
ವೃದ್ಧಿಯಾಗಿಲ್ಲ	W R IH D DH IH Y AA G IH L L
ವೇಗವಾಗಿ	W AE G AH W AA G IH
ವೇಳೆಯಲ್ಲಿ	W AE L EY Y AH L L IH
ವೈಖರಿಯನ್ನು	W AH IH K HH AH R IH Y AH N N UH
ವೈಯಕ್ತಿಕವಾಗಿ	W AH IH Y AH K T IH K AH W AA G IH
ವೈರಿ	W AH IH R IH
ವ್ಯಕ್ತಪಡಿಸಿತು	W Y AH K T AH P AH D IH S IH T UH
ವ್ಯಕ್ತಿಗತ	W Y AH K T IH G AH T
ವ್ಯತ್ಯಾಸವನ್ನು	W Y AH T Y AA S AH W AH N N UH
ವ್ಯವಸಾಯ	W Y AH W AH S AA Y
ವ್ಯವಸ್ಥೆ	W Y AH W AH S TH EY
ವ್ಯವಸ್ಥೆಗೆ	W Y AH W AH S TH EY G EY
ವ್ಯವಸ್ಥೆಯನ್ನು	W Y AH W AH S TH EY Y AH N N UH
ವ್ಯವಸ್ಥೆಯು	W Y AH W AH S TH EY Y UH
ವ್ಯವಸ್ಥೆಯೇ	W Y AH W AH S TH EY Y AE
ವ್ಯವಹರಿಸುವಂತಾಗಿದೆ	W Y AH W AH HH AH R IH S UH W AH N T AA G IH D EY
ವ್ಯವಹಾರಗಳ	W Y AH W AH HH AA R AH G AH L
ವ್ಯವಹಾರಗಳನ್ನು	W Y AH W AH HH AA R AH G AH L AH N N UH
ವ್ಯಾಪಾರ	W Y AA P AA R
ವ್ಯಾಪಾರದಿಂದಾಗಿ	W Y AA P AA R AH D IH N D AA G IH
ಶಂಕುವಿನಾಕೃತಿಯ	SH AH N K UH W IH N AA K R IH T IH Y
ಶಕುಂತಳಾ	SH AH K UH N T AH L AA
ಶಕ್ತಿ	SH AH K T IH
ಶತಮಾನಗಳಲ್ಲಿ	SH AH T AH M AA N AH G AH L AH L L IH
ಶತಮಾನದಲ್ಲಿ	SH AH T AH M AA N AH D AH L L IH
ಶಾಂತಿ	SH AA N T IH
ಶಾಬ್ದಿಕ	SH AA B D IH K
ಶಾಯೀ	SH AA Y IY
ಶಾಲೆಗೆ	SH AA L EY G EY
ಶಾಸನ	SH AA S AH N
ಶಾಸನಗಳನ್ನು	SH AA S AH N AH G AH L AH N N UH
ಶಾಸ್ತ್ರಿಗಳು	SH AA S T R IH G AH L UH
ಶಿಕ್ಷಕರು	SH IH K SH AH K AH R UH
ಶಿರಚ್ಛೇದನ	SH IH R AH CH CH AE D AH N
ಶಿಲ್ಪಗಳು	SH IH L P AH G AH L UH
ಶಿವಲಿಂಗ	SH IH W AH L IH N G
ಶುಕ್ಲಮಲ್ಲಿರಾಜನನ್ನು	SH UH K L AH M AH L L IH R AA JH AH N AH N N UH
ಶುಚಿಯಾಗಿ	SH UH CH IH Y AA G IH
ಶುಭಸಂದರ್ಭದಲ್ಲಿಯೂ	SH UH B HH AH S AH N D AH R B HH AH D AH L L IH Y UW
ಶೂನ್ಯಸಂಪಾದನೆಕಾರರಿಂದ	SH UW N Y AH S AH N P AA D AH N EY K AA R AH R IH N D
ಶೋಷಣೆ	SH AO SH AH N EY
ಶೋಷಣೆಗಿಂತ	SH AO SH AH N EY G IH N T
ಶೋಷಿತರ	SH AO SH IH T AH R
ಶೌರ್ಯ	SH AH OW R Y
ಶ್ರೀಕೃಷ್ಣ	SH R IY K R IH SH N
ಸ	S
ಸಂಕಷ್ಟದಿಂದ	S AH N K AH SH T AH D IH N D
ಸಂಕ್ರಮಣ	S AH N K R AH M AH N
ಸಂಖ್ಯೆ	S AH N K HH Y EY
ಸಂಗೊಳ್ಳಿಯ	S AH N G OW L L IH Y
ಸಂಘಟನೆಯೊಂದಿಗೆ	S AH N G HH AH T AH N EY Y OW N D IH G EY
ಸಂತತಿ	S AH N T AH T IH
ಸಂತಸಗೊಳ್ಳುತ್ತಿತ್ತು	S AH N T AH S AH G OW L L UH T T IH T T UH
ಸಂದರ್ಭದಲ್ಲಿ	S AH N D AH R B HH AH D AH L L IH
ಸಂದೇಶ	S AH N D AE SH
ಸಂದೇಹವೂ	S AH N D AE HH AH W UW
ಸಂಪನ್ಮೂಲಗಳನ್ನು	S AH N P AH N M UW L AH G AH L AH N N UH
ಸಂಪರ್ಕ	S AH N P AH R K
ಸಂಪರ್ಕದ	S AH N P AH R K AH D
ಸಂಪಾದಕ	S AH N P AA D AH K
ಸಂಪಾದನೆ	S AH N P AA D AH N EY
ಸಂಪುಟಕ್ಕೂ	S AH N P UH T AH K K UW
ಸಂಪುಟಗಳು	S AH N P UH T AH G AH L UH
ಸಂಪ್ರದಾಯಗಳ	S AH N P R AH D AA Y AH G AH L
ಸಂಬಂಧಪಟ್ಟ	S AH N B AH N DH AH P AH T T
ಸಂಬಂಧಪಟ್ಟಂತೆ	S AH N B AH N DH AH P AH T T AH N T EY
ಸಂಬಂಧವನ್ನು	S AH N B AH N DH AH W AH N N UH
ಸಂಬಂಧವಿದೆ	S AH N B AH N DH AH W IH D EY
ಸಂಬಂಧಿತವಾಗಿದೆ	S AH N B AH N DH IH T AH W AA G IH D EY
ಸಂಬಳ	S AH N B AH L
ಸಂಭಾಷಣೆ	S AH N B HH AA SH AH N EY
ಸಂವರ್ಧನೆ	S AH N W AH R DH AH N EY
ಸಂಶೋಧಕನ	S AH N SH AO DH AH K AH N
ಸಂಸ್ಕೃತಿ	S AH N S K R IH T IH
ಸಂಸ್ಕೃತಿಯು	S AH N S K R IH T IH Y UH
ಸಂಸ್ಥಾಪಕನು	S AH N S TH AA P AH K AH N UH
ಸಂಸ್ಥೆಯ	S AH N S TH EY Y
ಸಡಿಲಗೊಳಿಸುವ	S AH D IH L AH G OW L IH S UH W
ಸಣ್ಣ	S AH N N
ಸತ್ತರು	S AH T T AH R UH
ಸತ್ಯನಾಪುರೊತ್ತ	S AH T Y AH N AA P UH R OW T T
ಸದಸ್ಯರೊಂದಿಗೆ	S AH D AH S Y AH R OW N D IH G EY
ಸದಾ	S AH D AA
ಸದ್ಗತಿ	S AH D G AH T IH
ಸದ್ದುಮಾಡಿ	S AH D D UH M AA D IH
ಸಬಾಲ್ಟರ್ನ್ಚರಿತ್ರೆಕಾರರೂ	S AH B AA L T AH R N CH AH R IH T R EY K AA R AH R UW
ಸಭೆ	S AH B HH EY
ಸಮಯವನ್ನಾಧರಿಸಿ	S AH M AH Y AH W AH N N AA DH AH R IH S IH
ಸಮರ್ಥವಾಗಿ	S AH M AH R TH AH W AA G IH
ಸಮರ್ಪಕವಾಗಿ	S AH M AH R P AH K AH W AA G IH
ಸಮಸ್ಯೆಗಳಿದ್ದವು	S AH M AH S Y EY G AH L IH D D AH W UH
ಸಮಸ್ಯೆಯು	S AH M AH S Y EY Y UH
ಸಮಾಜ	S AH M AA JH
ಸಮಾಜದಲ್ಲಿ	S AH M AA JH AH D AH L L IH
ಸಮಾಜದಲ್ಲಿನ	S AH M AA JH AH D AH L L IH N
ಸಮಾಜವನ್ನು	S AH M AA JH AH W AH N N UH
ಸಮೀಪ	S AH M IY P
ಸರಕಾರ	S AH R AH K AA R
ಸರಕಾರಿ	S AH R AH K AA R IH
ಸರಣಿಯೇ	S AH R AH N IH Y AE
ಸರಳತೆ	S AH R AH L AH T EY
ಸರೋವರಗಳಲ್ಲಿ	S AH R AO W AH R AH G AH L AH L L IH
ಸರ್ಕಾರವು	S AH R K AA R AH W UH
ಸವಲತ್ತು	S AH W AH L AH T T UH
ಸಹರಾದ	S AH HH AH R AA D
ಸಹಾಯ	S AH HH AA Y
ಸಾಧನವಾಯಿತು	S AA DH AH N AH W AA Y IH T UH
ಸಾಧಿಸಿದ್ದರೂ	S AA DH IH S IH D D AH R UW
ಸಾಧ್ಯವಾಗಲಿಲ್ಲ	S AA DH Y AH W AA G AH L IH L L
ಸಾಧ್ಯವಾಗುತ್ತದೆ	S AA DH Y AH W AA G UH T T AH D EY
ಸಾನ್ಸ್ಕಿಲ್ಯೋಟಿಸಂ	S AA N S K IH L Y AO T IH S AH N
ಸಾಪೇಕ್ಷವಾಗಿ	S AA P AE K SH AH W AA G IH
ಸಾಮಗ್ರಿ	S AA M AH G R IH
ಸಾಮರ್ಥ್ಯದ	S AA M AH R TH Y AH D
ಸಾಮಾಜಿಕ	S AA M AA JH IH K
ಸಾಮಾನ್ಯವಾಗಿ	S AA M AA N Y AH W AA G IH
ಸಾಮ್ರಾಜ್ಯಗಳು	S AA M R AA JH Y AH G AH L UH
ಸಾಮ್ರಾಜ್ಯವನ್ನಲ್ಲದಿದ್ದರೂ	S AA M R AA JH Y AH W AH N N AH L L AH D IH D D AH R UW
ಸಾಮ್ರಾಜ್ಯವು	S AA M R AA JH Y AH W UH
ಸಾರುವ	S AA R UH W
ಸಾವು	S AA W UH
ಸಾವೊಶಂತ್ನ	S AA W OW SH AH N T N
ಸಾಹಿತ್ಯ	S AA HH IH T Y
ಸಾಹಿತ್ಯವಾಗಿದೆ	S AA HH IH T Y AH W AA G IH D EY
ಸಿಂಹಾಸನಕ್ಕೆ	S IH N HH AA S AH N AH K K EY
ಸಿಗಬೇಕು	S IH G AH B AE K UH
ಸಿಗುವ	S IH G UH W
ಸಿದ್ಧರ	S IH D DH AH R
ಸಿದ್ಧಾಂತವನ್ನು	S IH D DH AA N T AH W AH N N UH
ಸಿದ್ಧಾಂತವಾಗಿ	S IH D DH AA N T AH W AA G IH
ಸಿರಿ	S IH R IH
ಸೀಮಿತ	S IY M IH T
ಸೀರೆ	S IY R EY
ಸುಡುಗಾಡು	S UH D UH G AA D UH
ಸುತ್ತ	S UH T T
ಸುಧಾರಿಸುವ	S UH DH AA R IH S UH W
ಸುನ್ನಿ	S UH N N IH
ಸುರಿಸುತ್ತಾ	S UH R IH S UH T T AA
ಸುಲ್ಜುಕರು	S UH L JH UH K AH R UH
ಸೂತ್ರಧಾರನನ್ನು	S UW T R AH DH AA R AH N AH N N UH
ಸೂರನಾಯಕನ	S UW R AH N AA Y AH K AH N
ಸೂರಪ್ಪನಾಯಕ	S UW R AH P P AH N AA Y AH K
ಸೂರ್ಯದೇವ	S UW R Y AH D AE W
ಸೂರ್ಯನ	S UW R Y AH N
ಸೃಷ್ಟಿ	S R IH SH T IH
ಸೃಷ್ಟಿಯಾದುದು	S R IH SH T IH Y AA D UH D UH
ಸೆನೆಟ್ನಲ್ಲಿನ	S EY N EY T N AH L L IH N
ಸೆರೆಯಾಗಿ	S EY R EY Y AA G IH
ಸೆಳೆಯುತ್ತದೆ	S EY L EY Y UH T T AH D EY
ಸೇಮಿಗೆದ	S AE M IH G EY D
ಸೇರಿಸುವುದೆಂದರೆ	S AE R IH S UH W UH D EY N D AH R EY
ಸೇರುತ್ತದೆ	S AE R UH T T AH D EY
ಸೊಂಗಾರ್ಯ	S OW N G AA R Y
ಸೋಂಗೆ	S AO N G EY
ಸೋಜಿಗ	S AO JH IH G
ಸೋಲನ್ನು	S AO L AH N N UH
ಸ್ತಂಭಾಕಾರದ	S T AH N B HH AA K AA R AH D
ಸ್ತರಗಳ	S T AH R AH G AH L
ಸ್ಥಳೀಯವಾಗಿಯೇ	S TH AH L IY Y AH W AA G IH Y AE
ಸ್ಥಾನಕ್ಕೆ	S TH AA N AH K K EY
ಸ್ಥಾಪಿಸಿತು	S TH AA P IH S IH T UH
ಸ್ಥಾಪಿಸಿದ	S TH AA P IH S IH D
ಸ್ಥಾಪಿಸುವುದು	S TH AA P IH S UH W UH D UH
ಸ್ಥಿತಿ	S TH IH T IH
ಸ್ಪಷ್ಟವಾಗಿ	S P AH SH T AH W AA G IH
ಸ್ಮರಿಸಿಕೊಳ್ಳುತ್ತಾರೆ	S M AH R IH S IH K OW L L UH T T AA R EY
ಸ್ವತಂತ್ರವಾಗಿ	S W AH T AH N T R AH W AA G IH
ಸ್ವತಂತ್ರ್ಯ	S W AH T AH N T R Y
ಸ್ವಪ್ನದಲ್ಲಿ	S W AH P N AH D AH L L IH
ಸ್ವರೂಪದಲ್ಲಿದೆ	S W AH R UW P AH D AH L L IH D EY
ಸ್ವಾತಂತ್ರ್ಯ	S W AA T AH N T R Y
ಹಟ್ಟಿಯ	HH AH T T IH Y
ಹಣಕಾಸು	HH AH N AH K AA S UH
ಹಣ್ಣು	HH AH N N UH
ಹತ್ತನೆಯ	HH AH T T AH N EY Y
ಹತ್ತಿ	HH AH T T IH
ಹತ್ತಿಕ್ಕಿ	HH AH T T IH K K IH
ಹಬ್ಬವನ್ನು	HH AH B B AH W AH N N UH
ಹರಡಿತು	HH AH R AH D IH T UH
ಹಲವಾರು	HH AH L AH W AA R UH
ಹಲವು	HH AH L AH W UH
ಹಳೆಯ	HH AH L EY Y
ಹಳ್ಳಿಗಳಲ್ಲಿ	HH AH L L IH G AH L AH L L IH
ಹಸುಗಳನ್ನು	HH AH S UH G AH L AH N N UH
ಹಾಕಿದರೆ	HH AA K IH D AH R EY
ಹಾಗಾಗಿ	HH AA G AA G IH
ಹಾಗಿರಲಿಕ್ಕಿಲ್ಲಾ	HH AA G IH R AH L IH K K IH L L AA
ಹಾಗು	HH AA G UH
ಹಾಗೂ	HH AA G UW
ಹಾಗೆಯೇ	HH AA G EY Y AE
ಹಾಳಾಯಿತು	HH AA L AA Y IH T UH
ಹಾಸನ	HH AA S AH N
ಹಿಂದುಗಳಲ್ಲಿ	HH IH N D UH G AH L AH L L IH
ಹಿಂದೂ	HH IH N D UW
ಹಿಂದೆ	HH IH N D EY
ಹಿಡಿದ	HH IH D IH D
ಹಿಡಿಸಿತು	HH IH D IH S IH T UH
ಹಿತಾಸಕ್ತಿ	HH IH T AA S AH K T IH
ಹಿನ್ನೆಲೆಯಲ್ಲಿ	HH IH N N EY L EY Y AH L L IH
ಹಿರಿಯರಾದ	HH IH R IH Y AH R AA D
ಹಿರಿಯರಿಗೆ	HH IH R IH Y AH R IH G EY
ಹಿರಿಯರು	HH IH R IH Y AH R UH
ಹೀಗಾಗಿ	HH IY G AA G IH
ಹೀಗೆ	HH IY G EY
ಹುಟ್ಟಿಕೊಂಡವು	HH UH T T IH K OW N D AH W UH
ಹುಟ್ಟಿಕೊಂಡಿತು	HH UH T T IH K OW N D IH T UH
ಹುಟ್ಟಿದ	HH UH T T IH D
ಹುಟ್ಟಿದವನಂತೆ	HH UH T T IH D AH W AH N AH N T EY
ಹುಟ್ಟೂರುಗಳಲ್ಲಿ	HH UH T T UW R UH G AH L AH L L IH
ಹುಣ್ಣಿಮೆಯ	HH UH N N IH M EY Y
ಹುಲಿಗಳು	HH UH L IH G AH L UH
ಹುಲಿಗಳೊಂದಿಗೆ	HH UH L IH G AH L OW N D IH G EY
ಹುಲಿಮರಿಗಳನ್ನು	HH UH L IH M AH R IH G AH L AH N N UH
ಹುಸಿಯಾದರೂ	HH UH S IH Y AA D AH R UW
ಹೆಂಗಸರು	HH EY N G AH S AH R UH
ಹೆಚ್ಚಿ	HH EY CH CH IH
ಹೆಚ್ಚಿನ	HH EY CH CH IH N
ಹೆಚ್ಚು	HH EY CH CH UH
ಹೆಳವ	HH EY L AH W
ಹೆಸರಿಡುತ್ತಾನೆ	HH EY S AH R IH D UH T T AA N EY
ಹೆಸರಿನಲ್ಲಿ	HH EY S AH R IH N AH L L IH
ಹೆಸರುಗಳಿಂದ	HH EY S AH R UH G AH L IH N D
ಹೇಳಬೇಕೆಂದರೆ	HH AE L AH B AE K EY N D AH R EY
ಹೇಳಿ	HH AE L IH
ಹೇಳಿರುವ	HH AE L IH R UH W
ಹೇಳುತ್ತಾರೆ	HH AE L UH T T AA R EY
ಹೊಂದಿದ್ದರು	HH OW N D IH D D AH R UH
ಹೊಂದಿದ್ದವು	HH OW N D IH D D AH W UH
ಹೊಂದಿರಬೇಕು	HH OW N D IH R AH B AE K UH
ಹೊಂದುತ್ತದೆ	HH OW N D UH T T AH D EY
ಹೊಟ್ಟೆಯನ್ನು	HH OW T T EY Y AH N N UH
ಹೊತಟನು	HH OW T AH T AH N UH
ಹೊರಟುಹೋದವು	HH OW R AH T UH HH AO D AH W UH
ಹೊರತಾಗಿಲ್ಲ	HH OW R AH T AA G IH L L
ಹೊರತು	HH OW R AH T UH
ಹೊರಹೊಮ್ಮಿ	HH OW R AH HH OW M M IH
ಹೊಲೆಯ	HH OW L EY Y
ಹೊಸ	HH OW S
ಹೊಸದಾಗಿ	HH OW S AH D AA G IH
ಹೋದರೆ	HH AO D AH R EY
ಹೋದವಳು	HH AO D AH W AH L UH
ಹೋಯಿತು	HH AO Y IH T UH
ಹೋರಾಟದ	HH AO R AA T AH D
ಹೋರಿ	HH AO R IH
ಹೋಲಿಕೆಯಂತೆ	HH AO L IH K EY Y AH N T EY
ಹೋಲಿಸಿದರೆ	HH AO L IH S IH D AH R EY
ಹೋಳಿ	HH AO L IH