	
ಅಂಗವಾಗಿ	AH N G AH W AA G IH
ಅಂಗೀಕರಿಸಿತು	AH N G IY K AH R IH S IH T UH
ಅಂಚಿನಲ್ಲಿಯೇ	AH N CH IH N AH L L IH Y AE
ಅಂತಿಮ	AH N T IH M
ಅಂದಾಜು	AH N D AA JH UH
ಅಂದಿನ	AH N D IH N
ಅಕ್ಕಡಿಯನ್ನರು	AH K K AH D IH Y AH N N AH R UH
ಅಕ್ಕಡ್	AH K K AH D
ಅಗತ್ಯ	AH G AH T Y
ಅತಿ	AH T IH
ಅಥವಾ	AH TH AH W AA
ಅದನ್ನು	AH D AH N N UH
ಅದರ	AH D AH R
ಅದರಲ್ಲಿದ್ದುದು	AH D AH R AH L L IH D D UH D UH
ಅದು	AH D UH
ಅದೇ	AH D AE
ಅಧಿಕವಾಗಿ	AH DH IH K AH W AA G IH
ಅಧಿಕಾರ	AH DH IH K AA R
ಅಧಿಕಾರವನ್ನು	AH DH IH K AA R AH W AH N N UH
ಅಧಿಕಾರಿಗಳನ್ನು	AH DH IH K AA R IH G AH L AH N N UH
ಅನಂತರ	AH N AH N T AH R
ಅನುಭವಿಸಬೇಕಾಗಿ	AH N UH B HH AH W IH S AH B AE K AA G IH
ಅಪಾರವಾದ	AH P AA R AH W AA D
ಅಭಿವೃದ್ದಿಗೆ	AH B HH IH W R IH D D IH G EY
ಅಭಿವೃದ್ದಿಗೊಂಡು	AH B HH IH W R IH D D IH G OW N D UH
ಅಮ್ಮೋರೈಟ್ರ	AH M M AO R AH IH T R
ಅರಮನೆ	AH R AH M AH N EY
ಅರಮನೆಯನ್ನು	AH R AH M AH N EY Y AH N N UH
ಅರಮನೆಯಲ್ಲಿ	AH R AH M AH N EY Y AH L L IH
ಅರಾಜಕತೆ	AH R AA JH AH K AH T EY
ಅರಿಯಬೇಕಾದುದು	AH R IH Y AH B AE K AA D UH D UH
ಅರ್ಥ	AH R TH
ಅಲೆಮಾರಿ	AH L EY M AA R IH
ಅಲ್ಪಸಂಖ್ಯಾತರ	AH L P AH S AH N K HH Y AA T AH R
ಅಲ್ಲಿದ್ದವರನ್ನೆಲ್ಲಾ	AH L L IH D D AH W AH R AH N N EY L L AA
ಅವಕಾಶ	AH W AH K AA SH
ಅವನ್ನು	AH W AH N N UH
ಅವರ	AH W AH R
ಅವರಿಂದ	AH W AH R IH N D
ಅವರು	AH W AH R UH
ಅವಲಂಬಿಸಿತ್ತು	AH W AH L AH N B IH S IH T T UH
ಅವಶೇಷದಲ್ಲಿ	AH W AH SH AE SH AH D AH L L IH
ಅವಶ್ಯಕವಾಗಿತ್ತು	AH W AH SH Y AH K AH W AA G IH T T UH
ಅವುಗಳನ್ನು	AH W UH G AH L AH N N UH
ಅವುಗಳಲ್ಲಿ	AH W UH G AH L AH L L IH
ಅಸ್ತಿತ್ವಕ್ಕೆ	AH S T IH T W AH K K EY
ಅಸ್ಸಿರಿಯ	AH S S IH R IH Y
ಅಸ್ಸಿರಿಯನ್ನರಿಗೆ	AH S S IH R IH Y AH N N AH R IH G EY
ಆ	AA
ಆಕರಗಳ	AA K AH R AH G AH L
ಆಗಿತ್ತು	AA G IH T T UH
ಆಡಳಿತದವರನ್ನು	AA D AH L IH T AH D AH W AH R AH N N UH
ಆಡಳಿತಶಾಹಿಯನ್ನಾಗಿ	AA D AH L IH T AH SH AA HH IH Y AH N N AA G IH
ಆದ	AA D
ಆದಬನು	AA D AH B AH N UH
ಆದರೆ	AA D AH R EY
ಆದರ್ಶಪ್ರಾಯವಾದ	AA D AH R SH AH P R AA Y AH W AA D
ಆದಾಯ	AA D AA Y
ಆದಾಯವು	AA D AA Y AH W UH
ಆದುದರಿಂದಲೇ	AA D UH D AH R IH N D AH L AE
ಆಧಾರಗಳು	AA DH AA R AH G AH L UH
ಆಧುನಿಕ	AA DH UH N IH K
ಆನಂದಪಟ್ಟಿದ್ದಾನೆ	AA N AH N D AH P AH T T IH D D AA N EY
ಆಮದು	AA M AH D UH
ಆರಂಭದ	AA R AH N B HH AH D
ಆರಂಭವಾದುವು	AA R AH N B HH AH W AA D UH W UH
ಆರಂಭವಾಯಿತೆಂಬುದು	AA R AH N B HH AH W AA Y IH T EY N B UH D UH
ಆರ್ಥಿಕ	AA R TH IH K
ಆಳಿದ	AA L IH D
ಆಳಿದರು	AA L IH D AH R UH
ಆಳುತ್ತಿದ್ದಾಗ	AA L UH T T IH D D AA G
ಆಳುವ	AA L UH W
ಆಳ್ವಿಕೆಯ	AA L W IH K EY Y
ಆವೃತ್ತವಾಗಿದೆ	AA W R IH T T AH W AA G IH D EY
ಆಶ್ವಾಸನೆ	AA SH W AA S AH N EY
ಆಸ್ತಿ	AA S T IH
ಆಹಾರ	AA HH AA R
ಇಂದಿನ	IH N D IH N
ಇಟ್ಟಿಗೆಗಳನ್ನು	IH T T IH G EY G AH L AH N N UH
ಇಟ್ಟಿಗೆಗಳಿಗೆ	IH T T IH G EY G AH L IH G EY
ಇಡಲಾಗಿತ್ತು	IH D AH L AA G IH T T UH
ಇತಿಹಾಸದಲ್ಲಿ	IH T IH HH AA S AH D AH L L IH
ಇತ್ತು	IH T T UH
ಇದರ	IH D AH R
ಇದರಿಂದಾಗಿ	IH D AH R IH N D AA G IH
ಇದು	IH D UH
ಇದೆ	IH D EY
ಇದೇ	IH D AE
ಇದ್ದಾಗಲೇ	IH D D AA G AH L AE
ಇದ್ದೇ	IH D D AE
ಇನ್ನಷ್ಟು	IH N N AH SH T UH
ಇನ್ನು	IH N N UH
ಇನ್ನೂ	IH N N UW
ಇಬ್ಬರಲ್ಲಿ	IH B B AH R AH L L IH
ಇಬ್ಬಿಸಿನ್	IH B B IH S IH N
ಇರಾಕ್	IH R AA K
ಇರಾನಿನ	IH R AA N IH N
ಇರಿನ್ಲಾರ್ಸನ	IH R IH N L AA R S AH N
ಇರುವಂತೆಯೇ	IH R UH W AH N T EY Y AE
ಇಲ್ಲದಂತಿವೆ	IH L L AH D AH N T IH W EY
ಇಳಿಯಬಲ್ಲದು	IH L IH Y AH B AH L L AH D UH
ಇಳುವರಿಯಲ್ಲಿ	IH L UH W AH R IH Y AH L L IH
ಇವನ	IH W AH N
ಇವನು	IH W AH N UH
ಇವರ	IH W AH R
ಇವುಗಳಲ್ಲಿ	IH W UH G AH L AH L L IH
ಇವೆ	IH W EY
ಇವೆಲ್ಲ	IH W EY L L
ಇವೆಲ್ಲವುಗಳಿಂದ	IH W EY L L AH W UH G AH L IH N D
ಇಸಿನ್	IH S IH N
ಈ	IY
ಈಗ	IY G
ಈಸರ್ಹದನ್	IY S AH R HH AH D AH N
ಉಂಟಾಗಿ	UH N T AA G IH
ಉಗಮವಾಯಿತು	UH G AH M AH W AA Y IH T UH
ಉತುಹೆಗಲ್	UH T UH HH EY G AH L
ಉತ್ತರ	UH T T AH R
ಉತ್ತರದ	UH T T AH R AH D
ಉತ್ಪಾದನೆ	UH T P AA D AH N EY
ಉದ್ದೇಶವಾಗಿರಲಿಲ್ಲ	UH D D AE SH AH W AA G IH R AH L IH L L
ಉಬೈದ್	UH B AH IH D
ಉಮ್ಮಾ	UH M M AA
ಉರುಕ್	UH R UH K
ಉರುಕ್ನ	UH R UH K N
ಉರುಳಿಸಲು	UH R UH L IH S AH L UH
ಉರ್	UH R
ಉರ್ನಮ್ಮು	UH R N AH M M UH
ಉಳಿಸಿಕೊಂಡು	UH L IH S IH K OW N D UH
ಎಂದು	EY N D UH
ಎಂಬ	EY N B
ಎಂಬುವಲ್ಲಿ	EY N B UH W AH L L IH
ಎಂಬುವವನು	EY N B UH W AH W AH N UH
ಎತ್ತರವಾಗಿದ್ದು	EY T T AH R AH W AA G IH D D UH
ಎನ್ನುವ	EY N N UH W
ಎನ್ನುವುದೇ	EY N N UH W UH D AE
ಎರಡು	EY R AH D UH
ಎಲಮೈಟರನ್ನು	EY L AH M AH IH T AH R AH N N UH
ಎಲಾಮ್	EY L AA M
ಎಲ್ಲ	EY L L
ಎಲ್ಲಾ	EY L L AA
ಎಶ್ನುನ್ನ	EY SH N UH N N
ಏಕೆಂದರೆ	AE K EY N D AH R EY
ಏರಬಲ್ಲದು	AE R AH B AH L L AH D UH
ಏಳಲು	AE L AH L UH
ಐಸಿನ್	AH IH S IH N
ಒ	OW
ಒಂದಕ್ಕೊಂದು	OW N D AH K K OW N D UH
ಒಂದನೆಯ	OW N D AH N EY Y
ಒಂದು	OW N D UH
ಒಂದುಗೂಡಿಸಿದ	OW N D UH G UW D IH S IH D
ಒಣಗಿಸಿದ	OW N AH G IH S IH D
ಒದಗಿಸಲು	OW D AH G IH S AH L UH
ಒಬ್ಬನು	OW B B AH N UH
ಒಳಗಾದ	OW L AH G AA D
ಒಳಗೊಂಡಿತ್ತು	OW L AH G OW N D IH T T UH
ಓಡಿಸಿದನು	AO D IH S IH D AH N UH
ಕಂಕಣಬದ್ಧರಾದರು	K AH N K AH N AH B AH D DH AH R AA D AH R UH
ಕಂಡಿತು	K AH N D IH T UH
ಕಟ್ಟ	K AH T T
ಕಟ್ಟಿದ್ದನು	K AH T T IH D D AH N UH
ಕಡತಗಳನ್ನು	K AH D AH T AH G AH L AH N N UH
ಕಡೆಯವರಲ್ಲಿ	K AH D EY Y AH W AH R AH L L IH
ಕನ್ನಡಿಗನೂ	K AH N N AH D IH G AH N UW
ಕಮಿಸಾರರ	K AH M IH S AA R AH R
ಕರಾರುವಕ್ಕಾಗಿ	K AH R AA R UH W AH K K AA G IH
ಕರೆಯುತ್ತಾರೆ	K AH R EY Y UH T T AA R EY
ಕಲೆಯಲ್ಲಿ	K AH L EY Y AH L L IH
ಕಷ್ಟವನ್ನು	K AH SH T AH W AH N N UH
ಕಸಿದುಕೊಂಡು	K AH S IH D UH K OW N D UH
ಕಸ್ಸೈಟರು	K AH S S AH IH T AH R UH
ಕಾನೂನುಗಳ	K AA N UW N UH G AH L
ಕಾರಣಕ್ಕಾಗಿ	K AA R AH N AH K K AA G IH
ಕಾರಣವೆಂದರೆ	K AA R AH N AH W EY N D AH R EY
ಕಾರ್ಮಿಕ	K AA R M IH K
ಕಾರ್ಮಿಕರು	K AA R M IH K AH R UH
ಕಾಲಕ್ಕೆ	K AA L AH K K EY
ಕಾಲದ	K AA L AH D
ಕಾಲದಲ್ಲಿ	K AA L AH D AH L L IH
ಕಾಲದಿಂದ	K AA L AH D IH N D
ಕಾಲವನ್ನು	K AA L AH W AH N N UH
ಕಾಲವು	K AA L AH W UH
ಕಾವ್ಯರೂಪ	K AA W Y AH R UW P
ಕಿತ್ತು	K IH T T UH
ಕಿರಿದಾದ	K IH R IH D AA D
ಕಿರಿಯ	K IH R IH Y
ಕಿಶ್	K IH SH
ಕೂಡ	K UW D
ಕೂಡಿದರೆ	K UW D IH D AH R EY
ಕೃತಿಯ	K R IH T IH Y
ಕೆತ್ತಿಸಲಾಗಿದೆ	K EY T T IH S AH L AA G IH D EY
ಕೆರೆನ್ಸ್ಕಿ	K EY R EY N S K IH
ಕೇಂದ್ರ	K AE N D R
ಕೇಂದ್ರೀಕೃತ	K AE N D R IY K R IH T
ಕೈಗನ್ನಡಿಯಂತಿವೆ	K AH IH G AH N N AH D IH Y AH N T IH W EY
ಕೈಗಾರಿಕೆಗಳ	K AH IH G AA R IH K EY G AH L
ಕೈಗೆಕಾರ್ಮಿಕರಿಗೆ	K AH IH G EY K AA R M IH K AH R IH G EY
ಕೊಲೆ	K OW L EY
ಕೋಟೆಯ	K AO T EY Y
ಕ್ರಾಂತಿಕಾರರನ್ನು	K R AA N T IH K AA R AH R AH N N UH
ಕ್ರಾಂತಿಕಾರಿ	K R AA N T IH K AA R IH
ಕ್ರಾಂತಿಕಾರಿಗಳನ್ನು	K R AA N T IH K AA R IH G AH L AH N N UH
ಕ್ರಾಂತಿಕಾರಿಗಳು	K R AA N T IH K AA R IH G AH L UH
ಕ್ರಾಂತಿಯ	K R AA N T IH Y
ಕ್ರಾಂತಿಸೈನ್ಯಕ್ಕೆ	K R AA N T IH S AH IH N Y AH K K EY
ಕ್ರಿ	K R IH
ಗಂಗಿಗೌರೀ	G AH N G IH G AH OW R IY
ಗಡಿ	G AH D IH
ಗಡಿಯ	G AH D IH Y
ಗಣನೀಯವಾಗಿ	G AH N AH N IY Y AH W AA G IH
ಗಣನೀಯವಾದ	G AH N AH N IY Y AH W AA D
ಗರಿ	G AH R IH
ಗಾಯ	G AA Y
ಗುಂಪುಗಳಿಗೆ	G UH N P UH G AH L IH G EY
ಗುಣಲಕ್ಷಣಗಳು	G UH N AH L AH K SH AH N AH G AH L UH
ಗುದಿಯನ್ನು	G UH D IH Y AH N N UH
ಗುರಿಯಾಗಿತ್ತು	G UH R IH Y AA G IH T T UH
ಗೋಡೆಯು	G AO D EY Y UH
ಗೋಡೆಯೆಂದು	G AO D EY Y EY N D UH
ಗೌರವವಿತ್ತು	G AH OW R AH W AH W IH T T UH
ಗ್ರೀಕರು	G R IY K AH R UH
ಚಿಕ್ಕ	CH IH K K
ಚೆನ್ನಚೆರಿಬನ	CH EY N N AH CH EY R IH B AH N
ಜಗತ್ತಿನಲ್ಲಿ	JH AH G AH T T IH N AH L L IH
ಜಗತ್ತುಗಳ	JH AH G AH T T UH G AH L
ಜನರ	JH AH N AH R
ಜನರಕಾರ್ಮಿಕರ	JH AH N AH R AH K AA R M IH K AH R
ಜನರನ್ನು	JH AH N AH R AH N N UH
ಜನರಿಂದ	JH AH N AH R IH N D
ಜನರಿಗೆ	JH AH N AH R IH G EY
ಜನರು	JH AH N AH R UH
ಜನಸಂಖ್ಯೆಗೆ	JH AH N AH S AH N K HH Y EY G EY
ಜನಾಂಗಕ್ಕೆ	JH AH N AA N G AH K K EY
ಜನಾಂಗೀಯ	JH AH N AA N G IY Y
ಜಮಾಯಿಸುತ್ತಿದ್ದರು	JH AH M AA Y IH S UH T T IH D D AH R UH
ಜೀವನದ	JH IY W AH N AH D
ಜೀವನವು	JH IY W AH N AH W UH
ಜೂರಿ	JH UW R IH
ಜೋಕಾಲಿ	JH AO K AA L IH
ಜೋರಿನ	JH AO R IH N
ಟ್ರೈಗ್ರಿಸ್	T R AH IH G R IH S
ತಡೆಯಲು	T AH D EY Y AH L UH
ತನ್ನ	T AH N N
ತಮಗೆ	T AH M AH G EY
ತಮ್ಮ	T AH M M
ತಲೆತಪ್ಪಿಸಿಕೊಂಡು	T AH L EY T AH P P IH S IH K OW N D UH
ತಾತ್ಕಾಲಿಕ	T AA T K AA L IH K
ತಾಳಮೇಳ	T AA L AH M AE L
ತಾವೇ	T AA W AE
ತಿಳಿದಿದ್ದು	T IH L IH D IH D D UH
ತಿಳಿದುಬಂದಿಲ್ಲ	T IH L IH D UH B AH N D IH L L
ತಿಳಿಸುತ್ತದೆ	T IH L IH S UH T T AH D EY
ತೀರ್ಮಾನವಾಗದ	T IY R M AA N AH W AA G AH D
ತೀವ್ರವಾಗಿ	T IY W R AH W AA G IH
ತುಂಬ	T UH N B
ತುಂಬಾ	T UH N B AA
ತುಳಿತಕ್ಕೆ	T UH L IH T AH K K EY
ತೆಗೆಯಲಾಗಿರುವ	T EY G EY Y AH L AA G IH R UH W
ತೆನಿ	T EY N IH
ತೆನಿಗೆ	T EY N IH G EY
ತೆರನಾದ	T EY R AH N AA D
ದಂಗೆಗಳನ್ನು	D AH N G EY G AH L AH N N UH
ದಂಗೆಗಳು	D AH N G EY G AH L UH
ದಕ್ಷಿಣ	D AH K SH IH N
ದರೋಡೆಗಳು	D AH R AO D EY G AH L UH
ದಾಖಲೆಗಳಲ್ಲಿ	D AA K HH AH L EY G AH L AH L L IH
ದಾಳಿ	D AA L IH
ದಿನಗಳಲ್ಲಿ	D IH N AH G AH L AH L L IH
ದಿನನಿತ್ಯದ	D IH N AH N IH T Y AH D
ದುಃಸ್ಥಿತಿಗಳಿಂದ	D UH HH S TH IH T IH G AH L IH N D
ದುರ್ಕುರಿಗಲ್ಜು	D UH R K UH R IH G AH L JH UH
ದೂರ	D UW R
ದೇವರುಗಳ	D AE W AH R UH G AH L
ದೇವಸ್ಥಾನಗಳನ್ನು	D AE W AH S TH AA N AH G AH L AH N N UH
ದೇಶಕ್ಕೂ	D AE SH AH K K UW
ದೇಶಕ್ಕೆ	D AE SH AH K K EY
ದೇಶದ	D AE SH AH D
ದೇಹಕ್ಕೆ	D AE HH AH K K EY
ದೊರೆಯುತ್ತವೆ	D OW R EY Y UH T T AH W EY
ಧರಿಸಿ	DH AH R IH S IH
ಧಾನ್ಯದ	DH AA N Y AH D
ನಂತರ	N AH N T AH R
ನಗರ	N AH G AH R
ನಗರಗಳಲ್ಲಿ	N AH G AH R AH G AH L AH L L IH
ನಗರದ	N AH G AH R AH D
ನಗರದಲ್ಲಿ	N AH G AH R AH D AH L L IH
ನಗರರಾಜ್ಯಗಳು	N AH G AH R AH R AA JH Y AH G AH L UH
ನಗರರಾಜ್ಯದೊಡನೆ	N AH G AH R AH R AA JH Y AH D OW D AH N EY
ನಗರರಾಜ್ಯವನ್ನು	N AH G AH R AH R AA JH Y AH W AH N N UH
ನಗರವಾಗಿ	N AH G AH R AH W AA G IH
ನಗರವಾಗಿತ್ತು	N AH G AH R AH W AA G IH T T UH
ನಗರವಾಗಿರುತ್ತದೆ	N AH G AH R AH W AA G IH R UH T T AH D EY
ನಗರವು	N AH G AH R AH W UH
ನಗರವೊಂದನ್ನು	N AH G AH R AH W OW N D AH N N UH
ನಡುವೆ	N AH D UH W EY
ನಡುವೆಯೂ	N AH D UH W EY Y UW
ನಡೆಯುತ್ತಿದ್ದ	N AH D EY Y UH T T IH D D
ನಡೆಸಿದ	N AH D EY S IH D
ನದಿಗಳ	N AH D IH G AH L
ನದಿಯ	N AH D IH Y
ನಮಗೆ	N AH M AH G EY
ನಮ್ಮ	N AH M M
ನಾಗರಿಕತೆ	N AA G AH R IH K AH T EY
ನಾಗರಿಕತೆಯನ್ನು	N AA G AH R IH K AH T EY Y AH N N UH
ನಿಂತಿರುವ	N IH N T IH R UH W
ನಿಧಾನವಾಗಿ	N IH DH AA N AH W AA G IH
ನಿಪ್ಪೂರ್	N IH P P UW R
ನಿರ್ಧಾರದ	N IH R DH AA R AH D
ನಿರ್ಮಿಸಲಾದ	N IH R M IH S AH L AA D
ನಿರ್ಮಿಸಿದರು	N IH R M IH S IH D AH R UH
ನಿಲುಕುವ	N IH L UH K UH W
ನಿಶ್ಯಸ್ತ್ರೀಕರಿಸಿ	N IH SH Y AH S T R IY K AH R IH S IH
ನೀಡಲಾಗುತ್ತಿತ್ತು	N IY D AH L AA G UH T T IH T T UH
ನೀರನ್ನು	N IY R AH N N UH
ನೆಯಮಿಸಿದನು	N EY Y AH M IH S IH D AH N UH
ನೆಲಸಿದ್ದನೆಂದು	N EY L AH S IH D D AH N EY N D UH
ನೆಲೆ	N EY L EY
ನೇರ	N AE R
ನೊರಮ್ಸಿನ್ನನ	N OW R AH M S IH N N AH N
ನೋವುಗಳಿಗೆ	N AO W UH G AH L IH G EY
ನ್ನಾಗಿ	N N AA G IH
ನ್ಯಾಯಪಾಲನೆಗಿಂತ	N Y AA Y AH P AA L AH N EY G IH N T
ಪಟ್ಟಿ	P AH T T IH
ಪಡೆದುಕೊಳ್ಳುತ್ತಿದ್ದರು	P AH D EY D UH K OW L L UH T T IH D D AH R UH
ಪದೇ	P AH D AE
ಪದ್ಧತಿಯು	P AH D DH AH T IH Y UH
ಪರಿಣತಿಯನ್ನು	P AH R IH N AH T IH Y AH N N UH
ಪರಿಭಾಷೆಯಲ್ಲಿ	P AH R IH B HH AA SH EY Y AH L L IH
ಪರಿವರ್ತಿಸಿದನು	P AH R IH W AH R T IH S IH D AH N UH
ಪರಿಹಾರ	P AH R IH HH AA R
ಪಶ್ಚಿಮಕ್ಕೆ	P AH SH CH IH M AH K K EY
ಪಶ್ಚಿಮದಿಂದ	P AH SH CH IH M AH D IH N D
ಪಾಳು	P AA L UH
ಪುರಾತನ	P UH R AA T AH N
ಪೂರ್ವದಲ್ಲಿ	P UW R W AH D AH L L IH
ಪೆಟ್ರೋಗ್ರಾಡ್ಗೆ	P EY T R AO G R AA D G EY
ಪೆಟ್ರೋಗ್ರಾಡ್ನ	P EY T R AO G R AA D N
ಪ್ರಕಾರದ	P R AH K AA R AH D
ಪ್ರತಿಕ್ರಾಂತಿಕಾರಿಗಳ	P R AH T IH K R AA N T IH K AA R IH G AH L
ಪ್ರತಿಗಳನ್ನು	P R AH T IH G AH L AH N N UH
ಪ್ರತಿಗಳು	P R AH T IH G AH L UH
ಪ್ರತಿನಿಧಿಸುತ್ತದೆ	P R AH T IH N IH DH IH S UH T T AH D EY
ಪ್ರತಿಭಾಶಾಲಿಯಾದ	P R AH T IH B HH AA SH AA L IH Y AA D
ಪ್ರತಿಯೊಬ್ಬ	P R AH T IH Y OW B B
ಪ್ರದೇಶಕ್ಕೆ	P R AH D AE SH AH K K EY
ಪ್ರದೇಶಗಳಲ್ಲಿ	P R AH D AE SH AH G AH L AH L L IH
ಪ್ರದೇಶದ	P R AH D AE SH AH D
ಪ್ರದೇಶದಿಂದ	P R AH D AE SH AH D IH N D
ಪ್ರದೇಶವು	P R AH D AE SH AH W UH
ಪ್ರಧಾನಿ	P R AH DH AA N IH
ಪ್ರಪಂಚದ	P R AH P AH N CH AH D
ಪ್ರಭುತ್ವ	P R AH B HH UH T W
ಪ್ರಮುಖನಾಗಿದ್ದಾನೆ	P R AH M UH K HH AH N AA G IH D D AA N EY
ಪ್ರಮುಖವಾದ	P R AH M UH K HH AH W AA D
ಪ್ರಮುಖವಾದುವುಗಳೆಂದರೆ	P R AH M UH K HH AH W AA D UH W UH G AH L EY N D AH R EY
ಪ್ರಯತ್ನಿಸಿತು	P R AH Y AH T N IH S IH T UH
ಪ್ರಸಿದ್ಧವಾಗಿತ್ತು	P R AH S IH D DH AH W AA G IH T T UH
ಪ್ರಾಂತಗಳನ್ನಾಗಿ	P R AA N T AH G AH L AH N N AA G IH
ಪ್ರಾಂತ್ಯಕ್ಕೆ	P R AA N T Y AH K K EY
ಪ್ರಾಚೀನ	P R AA CH IY N
ಪ್ರಾಚ್ಯವಸ್ತು	P R AA CH Y AH W AH S T UH
ಪ್ರಾಚ್ಯವಸ್ತುಶಾಸ್ತ್ರದ	P R AA CH Y AH W AH S T UH SH AA S T R AH D
ಪ್ರಾರಂಭಗೊಂಡವು	P R AA R AH N B HH AH G OW N D AH W UH
ಫಲವತ್ತಾದ	F AH L AH W AH T T AA D
ಬಂಡವಾಳಶಾಹಿ	B AH N D AH W AA L AH SH AA HH IH
ಬಂಡಾಯಕ್ಕೆ	B AH N D AA Y AH K K EY
ಬಂತು	B AH N T UH
ಬಂದಂತಾಯಿತು	B AH N D AH N T AA Y IH T UH
ಬಂದಿತು	B AH N D IH T UH
ಬಂದಿದೆ	B AH N D IH D EY
ಬಂದಿದ್ದನು	B AH N D IH D D AH N UH
ಬಂದಿದ್ದವು	B AH N D IH D D AH W UH
ಬಗ್ಗೆ	B AH G G EY
ಬದಲಾಗಿ	B AH D AH L AA G IH
ಬದಲಾವಣೆಯನ್ನು	B AH D AH L AA W AH N EY Y AH N N UH
ಬದಲು	B AH D AH L UH
ಬರದಿರುವಂತೆ	B AH R AH D IH R UH W AH N T EY
ಬರವಣಿಗೆಯ	B AH R AH W AH N IH G EY Y
ಬರಹಗಳು	B AH R AH HH AH G AH L UH
ಬರುತ್ತಿದ್ದ	B AH R UH T T IH D D
ಬಲದಿಂದ	B AH L AH D IH N D
ಬಳಸಿಕೊಳ್ಳಬಹುದಿತ್ತು	B AH L AH S IH K OW L L AH B AH HH UH D IH T T UH
ಬಳಸಿದರು	B AH L AH S IH D AH R UH
ಬಹಳ	B AH HH AH L
ಬಹುರೀತಿಯಾಗಿ	B AH HH UH R IY T IH Y AA G IH
ಬಾಳ್ವೆಯ	B AA L W EY Y
ಬಿಟ್ಟುಬಿಡಲಾಯಿತು	B IH T T UH B IH D AH L AA Y IH T UH
ಬಿಡಿಸಿ	B IH D IH S IH
ಬಿದ್ದಿದ್ದ	B IH D D IH D D
ಬಿರುದುಗಳನ್ನು	B IH R UH D UH G AH L AH N N UH
ಬುಡಕಟ್ಟು	B UH D AH K AH T T UH
ಬುದ್ಧಿಗೆ	B UH D DH IH G EY
ಬೂದಿ	B UW D IH
ಬೃಹತ್ತಾದ	B R IH HH AH T T AA D
ಬೆಂಬಲಿಸತೊಡಗಿದರು	B EY N B AH L IH S AH T OW D AH G IH D AH R UH
ಬೆಟ್ಟಗಳ	B EY T T AH G AH L
ಬೆಟ್ಟಗಳಿಂದಲೂ	B EY T T AH G AH L IH N D AH L UW
ಬೆದಂಡೆಯನ್ನು	B EY D AH N D EY Y AH N N UH
ಬೆಬಿಲೋನಿಯ	B EY B IH L AO N IH Y
ಬೆಬಿಲೋನಿಯದಲ್ಲಿ	B EY B IH L AO N IH Y AH D AH L L IH
ಬೆಬಿಲೋನಿಯಾ	B EY B IH L AO N IH Y AA
ಬೆಳಕಿನಲ್ಲಿ	B EY L AH K IH N AH L L IH
ಬೆಳವಣಿಗೆಯನ್ನು	B EY L AH W AH N IH G EY Y AH N N UH
ಬೆಳವಣಿಗೆಯು	B EY L AH W AH N IH G EY Y UH
ಬೆಳೆಯಿತು	B EY L EY Y IH T UH
ಬೆಳೆಯುತ್ತಿದ್ದ	B EY L EY Y UH T T IH D D
ಬೆಳೆಸಿದರು	B EY L EY S IH D AH R UH
ಬೇಕಾದಂತೆ	B AE K AA D AH N T EY
ಬೇಯಿಸಿದ	B AE Y IH S IH D
ಬೇರೆ	B AE R EY
ಭಂಡಾರದಲ್ಲಿದ್ದು	B HH AH N D AA R AH D AH L L IH D D UH
ಭಾಗಗಳಲ್ಲಿ	B HH AA G AH G AH L AH L L IH
ಭಾಗದಲ್ಲಿ	B HH AA G AH D AH L L IH
ಭಾಗವೊಂದು	B HH AA G AH W OW N D UH
ಭಿನ್ನವಾಗಿತ್ತು	B HH IH N N AH W AA G IH T T UH
ಭೂ	B HH UW
ಭೂಮಿಯ	B HH UW M IH Y
ಭೌತಿಕವಾದ	B HH AH OW T IH K AH W AA D
ಮಂಡಳಿ	M AH N D AH L IH
ಮಗ	M AH G
ಮಗನಾದ	M AH G AH N AA D
ಮತ್ತು	M AH T T UH
ಮತ್ತೊಂದು	M AH T T OW N D UH
ಮತ್ತೊಮ್ಮೆ	M AH T T OW M M EY
ಮಧ್ಯಭಾಗದಲ್ಲಿ	M AH DH Y AH B HH AA G AH D AH L L IH
ಮನಸ್ಸು	M AH N AH S S UH
ಮನೆತನಗಳ	M AH N EY T AH N AH G AH L
ಮರಳುಗಾಡಿನಿಂದಲೂ	M AH R AH L UH G AA D IH N IH N D AH L UW
ಮಹಾನಗರಗಳು	M AH HH AA N AH G AH R AH G AH L UH
ಮಾಡಬಹುದಿತ್ತು	M AA D AH B AH HH UH D IH T T UH
ಮಾಡಲಾಗಿದೆ	M AA D AH L AA G IH D EY
ಮಾಡಲಾರರೆಂದು	M AA D AH L AA R AH R EY N D UH
ಮಾಡಿ	M AA D IH
ಮಾಡಿಕೊಂಡ	M AA D IH K OW N D
ಮಾಡಿಕೊಳ್ಳಲು	M AA D IH K OW L L AH L UH
ಮಾಡಿತು	M AA D IH T UH
ಮಾಡಿದ್ದರೆ	M AA D IH D D AH R EY
ಮಾಡಿಸಿದನು	M AA D IH S IH D AH N UH
ಮಾತ್ರ	M AA T R
ಮಾನವನು	M AA N AH W AH N UH
ಮಾರ್ಗದಂತೆ	M AA R G AH D AH N T EY
ಮಿಗಿಲಾಗಿ	M IH G IH L AA G IH
ಮಿಲಿಟರಿ	M IH L IH T AH R IH
ಮುಂದಿನ	M UH N D IH N
ಮುಂದು	M UH N D UH
ಮುಕ್ತ	M UH K T
ಮುಖ್ಯ	M UH K HH Y
ಮುಖ್ಯನಗರವೊಂದು	M UH K HH Y AH N AH G AH R AH W OW N D UH
ಮುಖ್ಯವಾದ	M UH K HH Y AH W AA D
ಮೂರನೆಯ	M UW R AH N EY Y
ಮೂರು	M UW R UH
ಮೂಲಗಳನ್ನು	M UW L AH G AH L AH N N UH
ಮೆಸಪಟೋಮಿ	M EY S AH P AH T AO M IH
ಮೆಸಪಟೋಮಿಯ	M EY S AH P AH T AO M IH Y
ಮೆಸಪಟೋಮಿಯದಲ್ಲಿ	M EY S AH P AH T AO M IH Y AH D AH L L IH
ಮೆಸಪಟೋಮಿಯಾದ	M EY S AH P AH T AO M IH Y AA D
ಮೇಲೆ	M AE L EY
ಮೊದಲ	M OW D AH L
ಮೊದಲನೆಯ	M OW D AH L AH N EY Y
ಮೊದಲಿಗೆ	M OW D AH L IH G EY
ಮೊದಲಿನ	M OW D AH L IH N
ಮೊದಲು	M OW D AH L UH
ಮೊಮ್ಮಗನಾದ	M OW M M AH G AH N AA D
ಯನ್ನು	Y AH N N UH
ಯಾದ	Y AA D
ಯಾರೂ	Y AA R UW
ಯಾವುದೇ	Y AA W UH D AE
ಯುದ್ಧಗಳ	Y UH D DH AH G AH L
ಯುಫ್ರೆಟಿಸ್	Y UH F R EY T IH S
ಯೋಜನೆ	Y AO JH AH N EY
ರಕ್ಷಣಾ	R AH K SH AH N AA
ರಕ್ಷಣೆಗೆ	R AH K SH AH N EY G EY
ರಷ್ಯಾದ	R AH SH Y AA D
ರಷ್ಯಾದಲ್ಲಿ	R AH SH Y AA D AH L L IH
ರಸ್ತೆಗಳಲ್ಲಿ	R AH S T EY G AH L AH L L IH
ರಾಜಕೀಯ	R AA JH AH K IY Y
ರಾಜಧಾನಿಯೂ	R AA JH AH DH AA N IH Y UW
ರಾಜನೆಂದು	R AA JH AH N EY N D UH
ರಾಜರು	R AA JH AH R UH
ರಾಜರುಗಳಿಗಿಂತ	R AA JH AH R UH G AH L IH G IH N T
ರಾಜ್ಯಗಳಿಂದ	R AA JH Y AH G AH L IH N D
ರಾಜ್ಯದ	R AA JH Y AH D
ರಾಜ್ಯಪಾಲರನ್ನಾಗಿ	R AA JH Y AH P AA L AH R AH N N AA G IH
ರಾಜ್ಯವನ್ನು	R AA JH Y AH W AH N N UH
ರಾಜ್ಯವನ್ನೆಲ್ಲ	R AA JH Y AH W AH N N EY L L
ರಾಶಿಯಾಗುವುದು	R AA SH IH Y AA G UH W UH D UH
ರಾಷ್ಟ್ರೀಯ	R AA SH T R IY Y
ರಾಷ್ಟ್ರೀಯತೆಗಳ	R AA SH T R IY Y AH T EY G AH L
ರೀತಿಯ	R IY T IH Y
ರೂಪಿಸಿದರು	R UW P IH S IH D AH R UH
ರೈತರ	R AH IH T AH R
ರೈತರಿಗೆ	R AH IH T AH R IH G EY
ಲಗಾಶನು	L AH G AA SH AH N UH
ಲಾಸಕ	L AA S AH K
ವರೆಸಿದವು	W AH R EY S IH D AH W UH
ವರ್ಗಗಳ	W AH R G AH G AH L
ವರ್ಗದವರನ್ನು	W AH R G AH D AH W AH R AH N N UH
ವರ್ಷಗಳ	W AH R SH AH G AH L
ವಸ್ತು	W AH S T UH
ವಸ್ತುಗಳು	W AH S T UH G AH L UH
ವಹಿಸಿಕೊಂಡರು	W AH HH IH S IH K OW N D AH R UH
ವಾಸವಾಗಿದ್ದ	W AA S AH W AA G IH D D
ವಿಂಗಡಿಸಿ	W IH N G AH D IH S IH
ವಿಚಾರಧಾರೆ	W IH CH AA R AH DH AA R EY
ವಿದೇಶಿ	W IH D AE SH IH
ವಿವಾದದ	W IH W AA D AH D
ವಿವಿಧ	W IH W IH DH
ವಿಶ್ವಾಸ	W IH SH W AA S
ವಿಷಯವಾಗಿದೆ	W IH SH AH Y AH W AA G IH D EY
ವಿಸ್ತರಿಸಿದರು	W IH S T AH R IH S IH D AH R UH
ವಿಸ್ತಾರವಾದ	W IH S T AA R AH W AA D
ವ್ಯವಸಾಯ	W Y AH W AH S AA Y
ವ್ಯವಸಾಯಕ್ಕೆ	W Y AH W AH S AA Y AH K K EY
ವ್ಯವಸಾಯದಿಂದ	W Y AH W AH S AA Y AH D IH N D
ವ್ಯವಸಾಯವನ್ನಾಧರಿಸಿದ	W Y AH W AH S AA Y AH W AH N N AA DH AH R IH S IH D
ವ್ಯವಸ್ಥೆಗೆ	W Y AH W AH S TH EY G EY
ವ್ಯವಸ್ಥೆಯ	W Y AH W AH S TH EY Y
ವ್ಯವಸ್ಥೆಯನ್ನು	W Y AH W AH S TH EY Y AH N N UH
ವ್ಯವಹರಿಸುತ್ತಿದ್ದರು	W Y AH W AH HH AH R IH S UH T T IH D D AH R UH
ಶಂಸಿ	SH AH N S IH
ಶಬ್ದವನ್ನು	SH AH B D AH W AH N N UH
ಶಸ್ತ್ರಾಸ್ತ್ರಗಳನ್ನು	SH AH S T R AA S T R AH G AH L AH N N UH
ಶಾಸನ	SH AA S AH N
ಶಾಸನದ	SH AA S AH N AH D
ಶುತ್ರುಕ್ನಹ್ಹುಂತೆ	SH UH T R UH K N AH HH HH UH N T EY
ಶುಲ್ಗಿ	SH UH L G IH
ಶುಲ್ಗಿಯು	SH UH L G IH Y UH
ಶೂಶಿನ್	SH UW SH IH N
ಶೋಧನೆಯಿಂದ	SH AO DH AH N EY Y IH N D
ಶ್ರೀಮಂತರ	SH R IY M AH N T AH R
ಶ್ರೇಣೀಕರಿಸಿದ	SH R AE N IY K AH R IH S IH D
ಸಂಗಮದ	S AH N G AH M AH D
ಸಂಘರ್ಷಗಳು	S AH N G HH AH R SH AH G AH L UH
ಸಂಪತ್ತಿನ	S AH N P AH T T IH N
ಸಂಬಂಧಗಳಿಗೆ	S AH N B AH N DH AH G AH L IH G EY
ಸಂಬಂಧಿಸಿದ	S AH N B AH N DH IH S IH D
ಸಂಬಂಧಿಸಿದಂತೆ	S AH N B AH N DH IH S IH D AH N T EY
ಸಂವಾದದ	S AH N W AA D AH D
ಸಂಶೋಧಕರ	S AH N SH AO DH AH K AH R
ಸಂಸ್ಕಾರದ	S AH N S K AA R AH D
ಸಂಸ್ಕೃತಿ	S AH N S K R IH T IH
ಸಂಸ್ಕೃತಿಯ	S AH N S K R IH T IH Y
ಸಂಸ್ಕೃತಿಯನ್ನೇ	S AH N S K R IH T IH Y AH N N AE
ಸಂಹಿತೆಗಳು	S AH N HH IH T EY G AH L UH
ಸಜ್ಜುಗೊಳಿಸಿದರು	S AH JH JH UH G OW L IH S IH D AH R UH
ಸಮತಟ್ಟಾದ	S AH M AH T AH T T AA D
ಸಮಸ್ಯೆಗಳ	S AH M AH S Y EY G AH L
ಸಮಾಜದ	S AH M AA JH AH D
ಸಮಾನತೆ	S AH M AA N AH T EY
ಸಮಾನತೆಯ	S AH M AA N AH T EY Y
ಸಮಿತಿ	S AH M IH T IH
ಸರಕಾರದ	S AH R AH K AA R AH D
ಸರಕಾರದಿಂದಲೇ	S AH R AH K AA R AH D IH N D AH L AE
ಸರಕಾರವು	S AH R AH K AA R AH W UH
ಸರಿಯಾಗಿ	S AH R IH Y AA G IH
ಸರಿಯುವಂತಾಯಿತು	S AH R IH Y UH W AH N T AA Y IH T UH
ಸವಾಲುಗಳನ್ನು	S AH W AA L UH G AH L AH N N UH
ಸಶಸ್ತ್ರ	S AH SH AH S T R
ಸಹಾಯ	S AH HH AA Y
ಸಹಾಯಕ	S AH HH AA Y AH K
ಸಾಧಿಸಲಾಗಿರುವ	S AA DH IH S AH L AA G IH R UH W
ಸಾಧ್ಯವಾಯಿತು	S AA DH Y AH W AA Y IH T UH
ಸಾಮಾಜಿಕ	S AA M AA JH IH K
ಸಾಮಾಜಿಕವಾಗಿ	S AA M AA JH IH K AH W AA G IH
ಸಾಮ್ರಾಜ್ಯದ	S AA M R AA JH Y AH D
ಸಾಮ್ರಾಜ್ಯವನ್ನೇ	S AA M R AA JH Y AH W AH N N AE
ಸಾರ್ವಭೌಮತೆ	S AA R W AH B HH AH OW M AH T EY
ಸಾವಿರ	S AA W IH R
ಸಾಹಿತ್ಯದೃಷ್ಟಿಯಿಂದ	S AA HH IH T Y AH D R IH SH T IH Y IH N D
ಸಿಕ್ಕಿದೆ	S IH K K IH D EY
ಸಿಗುತ್ತವೆ	S IH G UH T T AH W EY
ಸುಟ್ಟು	S UH T T UH
ಸುಧಾರಿಸಿತು	S UH DH AA R IH S IH T UH
ಸುಮಾರು	S UH M AA R UH
ಸುಮೇರನ್ನು	S UH M AE R AH N N UH
ಸುಮೇರಿಯನ್	S UH M AE R IH Y AH N
ಸುಮೇರಿಯನ್ನರ	S UH M AE R IH Y AH N N AH R
ಸುಮೇರ್	S UH M AE R
ಸುಸ	S UH S
ಸೂರ್ಯನ	S UW R Y AH N
ಸೃಷ್ಟಿಸಿರುತ್ತಾರೆ	S R IH SH T IH S IH R UH T T AA R EY
ಸೇತುವೆಗಳನ್ನು	S AE T UH W EY G AH L AH N N UH
ಸೇನೆ	S AE N EY
ಸೇರಿದವರಾಗಿದ್ದ	S AE R IH D AH W AH R AA G IH D D
ಸೈನಿಕರನ್ನು	S AH IH N IH K AH R AH N N UH
ಸೋವಿಯತ್	S AO W IH Y AH T
ಸ್ತಬ್ಧಗೊಳಿಸುವುದಷ್ಟೆ	S T AH B DH AH G OW L IH S UH W UH D AH SH T EY
ಸ್ಥಳದಲ್ಲಿ	S TH AH L AH D AH L L IH
ಸ್ಥಳೀಯ	S TH AH L IY Y
ಸ್ಥಾಪಿಸಲಾಯಿತು	S TH AA P IH S AH L AA Y IH T UH
ಸ್ಪಷ್ಟ	S P AH SH T
ಸ್ಪಷ್ಟಪಡಿಸುತ್ತವೆ	S P AH SH T AH P AH D IH S UH T T AH W EY
ಸ್ಪಷ್ಟವಾಗಿ	S P AH SH T AH W AA G IH
ಸ್ಪಷ್ಟವಾದವು	S P AH SH T AH W AA D AH W UH
ಸ್ವತಂತ್ರವಾಗಿ	S W AH T AH N T R AH W AA G IH
ಸ್ವಯಂ	S W AH Y AH N
ಸ್ವೀಕರಿಸಿ	S W IY K AH R IH S IH
ಹಂತವಾಗಿತ್ತು	HH AH N T AH W AA G IH T T UH
ಹಕ್ಕು	HH AH K K UH
ಹಣಕಾಸಿನ	HH AH N AH K AA S IH N
ಹತ್ತಿಕ್ಕಲು	HH AH T T IH K K AH L UH
ಹನಿ	HH AH N IH
ಹನಿಗೆ	HH AH N IH G EY
ಹಮುರಾಬಿ	HH AH M UH R AA B IH
ಹರಳುಗಳು	HH AH R AH L UH G AH L UH
ಹರಿಯುವ	HH AH R IH Y UH W
ಹಲವು	HH AH L AH W UH
ಹಳೆಯ	HH AH L EY Y
ಹಳೆಯದು	HH AH L EY Y AH D UH
ಹಳ್ಳವಾಗುವುದು	HH AH L L AH W AA G UH W UH D UH
ಹಳ್ಳಿ	HH AH L L IH
ಹಳ್ಳಿಗ	HH AH L L IH G
ಹಳ್ಳಿಗಳ	HH AH L L IH G AH L
ಹವಾಗುಣ	HH AH W AA G UH N
ಹಸ್ತಪ್ರತಿ	HH AH S T AH P R AH T IH
ಹಾಕಿ	HH AA K IH
ಹಾಡುಕಟ್ಟಿದ್ದಾನೆ	HH AA D UH K AH T T IH D D AA N EY
ಹಾದು	HH AA D UH
ಹೀಗೆ	HH IY G EY
ಹುಟ್ಟನ್ನು	HH UH T T AH N N UH
ಹುಟ್ಟಿಕೊಂಡದ್ದು	HH UH T T IH K OW N D AH D D UH
ಹುಟ್ಟಿಕೊಂಡಿತು	HH UH T T IH K OW N D IH T UH
ಹೆಚ್ಚಾಗಿತ್ತು	HH EY CH CH AA G IH T T UH
ಹೆಚ್ಚಾದವು	HH EY CH CH AA D AH W UH
ಹೆಚ್ಚಿನ	HH EY CH CH IH N
ಹೆಚ್ಚಿನದೇನೂ	HH EY CH CH IH N AH D AE N UW
ಹೆಚ್ಚು	HH EY CH CH UH
ಹೆಣ್ಣುವೇಷ	HH EY N N UH W AE SH
ಹೆಸರಿತ್ತು	HH EY S AH R IH T T UH
ಹೇಳುವುದಾದರೆ	HH AE L UH W UH D AA D AH R EY
ಹೊಡೆದು	HH OW D EY D UH
ಹೊರ	HH OW R
ಹೊಸ	HH OW S
ಹೋಗಿತ್ತು	HH AO G IH T T UH
ಹೋದರು	HH AO D AH R UH