इन्फेंट	 IH N F EY N T
एप्पल	 EY P P AH L
एयरटेल	 EY Y AH R AH T EY L
ऐपेरल	 AE P EY R AH L
ऐसेसरीज़	 AE S EY S AH R IY Z
ऑटोमेशन	 AO T OW M EY SH AH N
कंप्यूटर्स	 K AH M P Y UH T AH R S
कमरेला	 K AH M AH R EY L AA
कर्लर	 K AH R L AH R
क्लॉक्स	 K L AO K S
चान्दी	 CH AA N D IY
चार्जींग	 CH AA R JH IY N G
डोकोमो	 D OW K OW M OW
तेंडुलकर	 T EY N D UW L AH K AH R
थर्मल	 TH AH R M AH L
नेवी	 N EY W IY
फरनिशिंग	 F AH R AH N IH SH IH N G
बांधब्याचा	 B AA N DH AH B Y AA CH AA
बोर्न	 B OW R N
मुनफ्फा	 M UW N AH F F AA
रेड्मी	 R EY D M IY
रेलिश	 R EY L IH SH
रोबोटिक्स	 R OW B OW T IH K S
लक्षमी	 L AH K SH AH M IY
विक्रोमा	 W IH K R OW M AA
वूलेन	 W UH L EY N
सचिन	 S AH CH IH N
सीटिंग	 S IY T IH N G
स्टैंड्स	 S T AE N D S
हैंडबैग्स	 HH AE N D AH B AE G S
हॉटरूम	 HH AO T AH R UH M
फ़ोन्स	 F OW N S
