technology	T EH K N AA L AH JH IY
jack	JH AE K
grim	G R IH M
pouch	P AW CH
bollywood	B AA L IY W UH D
bollywood(2)	B AO L IH W UH D
ideas	AY D IY AH Z
jrf	JH EY AA R F
sairam	S AE AH R AH M
electro	IH L EH K T R OW
get	G EH T
get(2)	G IH T
words	W ER D Z
skills	S K IH L Z
care	K EH R
south	S AW TH
relationship	R IY L EY SH AH N SH IH P
learn	L ER N
kitchens	K IH CH AH N Z
breaks	B R EY K S
newyork	N Y UW AY AH R K
uranium	Y ER EY N IY AH M
microscope	M AY K R AH S K OW P
bike	B AY K
rejuvenation	R IH JH UW V AH N EY SH AH N
saurashtra	S AW R AA SH T R AH
microwave	M AY K R AH W EY V
art	AA R T
r	AA R
diamond	D AY M AH N D
diamond(2)	D AA IH M AH N D
depot	D IY P OW
depot(2)	D EY P OW
depot(3)	D IH P OW
nitai	N IH T EY
girls	G ER L Z
dalai	D AE L EY
dalai(2)	D AO L AY
dalai(3)	D AA L IY
dalai(4)	D AH L AA IY
dalai(5)	D AH L AY
next	N EH K S T
next(2)	N EH K S
family	F AE M AH L IY
family(2)	F AE M L IY
family(3)	F AE M IH L IY
recipes	R EH S AH P IY Z
breath	B R EH TH
handbook	HH AE N D B UH K
large	L AA R JH
b	B IY
pods	P AA D Z
pods(2)	P AO D Z
cellular	S EH L Y AH L ER
cellular(2)	S AE L Y UH L ER
wireless	W AY R L IH S
tailor	T EY L ER
slick	S L IH K
meeting	M IY T IH NG
rosy	R OW Z IY
royalista	R OY AH L IH S T AH
royalista(2)	R OY AH L IH S T AA
furnishers	F ER N IH SH ER Z
head	HH EH D
asus	EY S AH S
asus(2)	EY Z AH S
rich	R IH CH
also	AO L S OW
replacement	R IH P L EY S M AH N T
replacement(2)	R IH P L EY S M EY N T
hobbies	HH AA B IY Z
hobbies(2)	HH AO B IY Z
movies	M UW V IY Z
stop	S T AA P
stop(2)	S T AO P
hundred	HH AH N D R AH D
hundred(2)	HH AH N D R IH D
hundred(3)	HH AH N ER D
hundred(4)	HH AH N D ER D
hundred(5)	HH AH N D R EH D
be	B IY
kalakunj	K AH L AA K UH N JH
zenco	Z EH NG K OW
appreciation	AH P R IY SH IY EY SH AH N
appreciation(2)	AE P R IY SH IY EY SH AH N
appreciation(3)	AE P R IH SH IY EY SH AH N
voyage	V OY AH JH
voyage(2)	V OY IH JH
voyage(3)	V OY EY JH
voyage(4)	V AO Y EY JH
doodlez	D UW D L AH Z
doodlez(2)	D UW D L Z
karma	K AH R M AA
jones	JH OW N Z
nursery	N ER S ER IY
nursery	N AH R S AH R IY
volume	V AA L Y UW M
volume(2)	V AO L Y UW M
shiv	SH IH V
goa	G OW AA
goa	G OW W AA
on	AA N
on(2)	AO N
thief	TH IY F
return	R IH T ER N
return(2)	R IY T ER N
rajshri	R AA JH AH SH R IY
rajshri(2)	R AA JH SH R IY
shriram	SH R IY R AA M
baby	B EY B IY
appliances	AH P L AY AH N S AH Z
appliances(2)	AH P L AY AH N S IH Z
appliances(3)	AE P L AY AH N S IH Z
appliances(4)	AE P L AY AH N S EY Z
cellphone	S EH L F OW N
vision	V IH ZH AH N
raj	R AA ZH
raj(2)	R AA JH
conversations	K AA N V ER S EY SH AH N Z
conversations(2)	K AO N V ER Z EY SH AH N S
losing	L UW Z IH NG
by	B AY
steroids	S T EH R OY D Z
minute	M IH N AH T
minute(2)	M AY N UW T
minute(3)	M AY N Y UW T
minute(4)	M IH N IH T
all	AO L
item	AY T AH M
prams	P R AE M Z
homes	HH OW M Z
rajiv	R AA JH IY V
rajiv(2)	R AA ZH IY V
moths	M AO TH S
bazaar	B AH Z AA R
peter	P IY T ER
peter(2)	P IY T AH R
weight	W EY T
class	K L AE S
class(2)	K L AA S
cushions	K UH SH AH N Z
money	M AH N IY
discrete	D IH S K R IY T
maithili	M EY TH AH L IY
maithili(2)	M AE TH IH L IY
tech	T EH K
tech(2)	T AE K
electromagnetic	IH L EH K T R OW M AE G N EH T IH K
electromagnetic(2)	IH L AE K T R OW M AE G N EH T IH K
slaughter	S L AO T ER
slaughter(2)	S L AO T AH R
gift	G IH F T
beens	B IY N S
within	W IH DH IH N
within(2)	W IH TH IH N
within(3)	W IH D IH N
guide	G AY D
guide(2)	G AA IY D
was	W AA Z
was(2)	W AH Z
was(3)	W AO Z
stitch	S T IH CH
phoenix	F IY N IH K S
sam	S AE M
motorcycle	M OW T ER S AY K AH L
laid	L EY D
flip	F L IH P
ate	EY T
bhadreshwara	B HH AA D R EY SH W AH R AH
deco	D EH K OW
saree	S AA R IY
silver	S IH L V ER
grainger	G R EY NG JH ER
grainger(2)	G R EY NG ER
small	S M AO L
caps	K AE P S
unseen	AH N S IY N
av	EY V IY
ulhasnagar	UH L HH AA S N AH G AH R
ulhasnagar(2)	UH L HH AA S N AH G ER
shreyaan	SH R EY Y AA N
physician	F IH Z IH SH AH N
physician(2)	F IH Z IH SH IH Y AH N
mahavira	M AH HH AA V IY R AA
earth	ER TH
earth(2)	AH R TH
ring	R IH NG
optoelectronics	AA P T OW AH L EH K T R AH N AH S Z
optoelectronics(2)	AA P T OW IH L EH K T R AH N AH S Z
optoelectronics(3)	AO P T OW IH L EH K T R AO N IH K S
crack	K R AE K
dress	D R EH S
troubleshooting	T R AH B AH L SH UW T IH NG
dossier	D AO S Y EY
dossier(2)	D AO S IY EY
dossier(3)	D AO S IY ER
decorative	D EH K R AH T IH V
decorative(2)	D AE K OW R EY T IH V
paint	P EY N T
conservatives	K AH N S ER V AH T IH V Z
falcon	F AE L K AH N
neo	N IY OW
printed	P R IH N T IH D
printed(2)	P R IH N AH D
printed(3)	P R IH N IH D
printed(4)	P R IH N T AH D
tradition	T R AH D IH SH AH N
conductivity	K AA N D AH K T IH V AH T IY
hardware	HH AA R D W EH R
simple	S IH M P AH L
android	AE N D R OY D
club	K L AH B
oven	AH V AH N
students	S T UW D AH N T S
designer	D IH Z AY N ER
jodhpur	JH AO D P ER
offensives	AH F EH N S IH V Z
bath	B AE TH
potter	P AA T ER
ethno	EH TH N OW
mitashi	M IH T AH SH IY
register	R EH JH IH S T ER
hi	HH AY
sikhs	S IY K S
trans	T R AE N Z
chicken	CH IH K AH N
baniye	B EY N IY AY
rid	R IH D
called	K AO L D
crime	K R AY M
smiths	S M IH TH S
chemical	K EH M AH K AH L
chemical(2)	K EH M IH K AH L
waste	W EY S T
ocean	OW SH AH N
non	N AA N
banish	B AE N IH SH
focus	F OW K AH S
focus(2)	F OW K IH S
umbrella	AH M B R EH L AH
fresh	F R EH SH
happiness	HH AE P IY N AH S
hanu	HH AE N UW
apprentice	AH P R EH N T AH S
apprentice(2)	AH P R EH N T IH S
abc	EY B IY S IY
abc(2)	AE B K
proposals	P R AH P OW Z AH L Z
laundry	L AO N D R IY
laxmi	L AE K S M IY
natural	N AE CH ER AH L
natural(2)	N AE CH R AH L
precision	P R IY S IH ZH AH N
charger	CH AA R JH ER
pain	P EY N
home	HH OW M
diaper	D AY P ER
black	B L AE K
my	M AY
soul	S OW L
intervention	IH N T ER V EH N SH AH N
indigo	IH N D AH G OW
indigo(2)	IH N D IH G OW
design	D IH Z AY N
headphone	HH EH D F OW N
potential	P AH T EH N SH AH L
over	OW V ER
adapter	AH D AE P T ER
cross	K R AO S
cracking	K R AE K IH NG
with	W IH DH
with(2)	W IH TH
top	T AA P
top(2)	T AO P
point	P OY N T
merry	M EH R IY
goddess	G AA D AH S
second	S EH K AH N D
simplification	S IH M P L AH F IH K EY SH AH N
mathematics	M AE TH AH M AE T IH K S
hypo	HH AY P OW
houses	HH AW S AH Z
houses(2)	HH AW S IH Z
cisco	S IH S K OW
joy	JH OY
effective	IH F EH K T IH V
effective(2)	IY F EH K T IH V
freedom	F R IY D AH M
inter	IH N T ER
veera	V IH R AH
affinity	AH F IH N AH T IY
affinity(2)	AH F IH N IH T IY
sarees	S AH R IY Z
him	HH IH M
him(2)	IH M
knowlegde	N OW L AH G D
safety	S EY F T IY
aero	EH R OW
hangers	HH AE NG ER Z
computers	K AH M P Y UW T ER Z
jewellers	JH UW AH L ER Z
jewellers(2)	JH UW L ER Z
undifferentiated	AH N D IH F ER EH N SH IY EY T IH D
autobiographies	AO T AH B AY AA G R AH F IY Z
vinayak	V IH N EY AH K
shivaji	SH IH V AH JH IY
nation	N EY SH AH N
these	DH IY Z
eastern	IY S T ER N
media	M IY D IY AH
problem	P R AA B L AH M
confectionaries	K AH N F EH K SH AH N EH R IY Z
priyanshi	P R AY AY AE N SH IY
boarding	B AO R D IH NG
bravia	B R EY V IY AH
search	S ER CH
yoga	Y OW G AH
inspirational	IH N S P ER EY SH AH N AH L
agriculture	AE G R IH K AH L CH ER
toys	T OY Z
cd	S IY D IY
jewelry	JH UW AH L R IY
jewelry(2)	JH UW L R IY
jewelry(3)	JH UW L ER IY
position	P AH Z IH SH AH N
everyone	EH V R IY W AH N
practice	P R AE K T AH S
practice(2)	P R AE K T IH S
air	EH R
supervisory	S UW P ER V AY Z ER IY
pipeline	P AY P L AY N
creativity	K R IY EY T IH V AH T IY
like	L AY K
clerk	K L ER K
moon	M UW N
posters	P OW S T ER Z
hub	HH AH B
bahurani	B AE HH Y UH R AH N IY
sting	S T IH NG
premium	P R IY M IY AH M
laboratory	L AE B R AH T AO R IY
almost	AO L M OW S T
simply	S IH M P L IY
plasticity	P L AE S T IH S AH T IY
mechanical	M AH K AE N IH K AH L
employee	EH M P L OY IY
employee(2)	IH M P L OY IY
wrist	R IH S T
phone	F OW N
brokerages	B R OW K ER IH JH IH Z
brokerages(2)	B R OW K R IH JH IH Z
quantitatively	K W AA N T IH T EY T AH V L IY
autobiographical	AO T AH B AY AH G R AE F IH K AH L
watches	W AA CH AH Z
watches(2)	W AA CH IH Z
anatomy	AH N AE T AH M IY
denuclearization	D IY N UW K L IY ER AH Z EY SH AH N
religion	R IH L IH JH AH N
religion(2)	R IY L IH JH AH N
cookbook	K UH K B UH K
series	S IH R IY Z
lamas	L AA M AH Z
cat	K AE T
hero	HH IH R OW
hero(2)	HH IY R OW
dictionary	D IH K SH AH N EH R IY
cover	K AH V ER
forwardly	F AO R W ER D L IY
schedule	S K EH JH UH L
schedule(2)	S K EH JH UW L
viz	V IH ZH
representatives	R EH P R AH Z EH N T AH T IH V Z
representatives(2)	R EH P R IH Z EH N T AH T IH V Z
representatives(3)	R EH P R AH Z EH N AH T IH V Z
representatives(4)	R EH P R IH Z EH N AH T IH V Z
shraddha	SH R AE D HH AH
grooming	G R UW M IH NG
close	K L OW S
close(2)	K L OW Z
teaching	T IY CH IH NG
diary	D AY ER IY
diary(2)	D AY R IY
reflexotherapy	R IY F L EH K S AH DH ER EY P IY
nothing	N AH TH IH NG
vivek	V IH V AH K
khan	K HH AA N
khan(2)	K AA N
bluetooth	B L UW T UW TH
weaving	W IY V IH NG
tort	T AO R T
one	W AH N
one(2)	HH W AH N
homoeopathic	HH AA M OW EH AH P AH TH AH K
brand	B R AE N D
growing	G R OW IH NG
war	W AO R
excellence	EH K S AH L AH N S
they	DH EY
hitachi	HH IH T AA CH IY
linen	L IH N AH N
macro	M AE K R OW
wave	W EY V
texture	T EH K S CH ER
amritsar	AE M R IH T S ER
amritsar(2)	AE M R IH T S AA R
sections	S EH K SH AH N Z
startup	S T AA R T AH P
reconsideration	R IY K AH N S IH D ER EY SH AH N
footwear	F UH T W EH R
manures	M EY N Y ER Z
keith	K IY TH
exam	IH G Z AE M
philosophy	F AH L AA S AH F IY
way	W EY
imposition	IH M P AH Z IH SH AH N
terrorist	T EH R ER IH S T
terrorist(2)	T EH R AH R IH S T
developmentally	D IH V EH L AH P M EH N AH L IY
developmentally(2)	D IH V EH L AH P M EH N T AH L IY
center	S EH N T ER
center(2)	S EH N ER
pradesh	P R AH D EH SH
darpan	D AA R P AH N
writing	R AY T IH NG
rabindranath	R AH B IH N D R AH N AH TH
software	S AO F T W EH R
software(2)	S AO F W EH R
scrap	S K R AE P
collaboration	K AH L AE B ER EY SH AH N
aadinath	AA D AH N AH TH
plus	P L AH S
fun	F AH N
helmet	HH EH L M AH T
face	F EY S
real	R IY L
ipad	AY P AE D
development	D IH V EH L AH P M AH N T
paradise	P EH R AH D AY S
hog	HH AA G
fathom	F AE DH AH M
engineering	EH N JH AH N IH R IH NG
english	IH NG G L IH SH
english(2)	IH NG L IH SH
light	L AY T
chains	CH EY N Z
joke	JH OW K
dependence	D IH P EH N D AH N S
insurgencies	IH N S ER JH AH N S IY Z
structures	S T R AH K CH ER Z
are	AA R
are(2)	ER
human	HH Y UW M AH N
human(2)	Y UW M AH N
ladies	L EY D IY Z
conditioning	K AH N D IH SH AH N IH NG
taps	T AE P S
near	N IH R
in	IH N
officer	AO F AH S ER
officer(2)	AO F IH S ER
principles	P R IH N S AH P AH L Z
shristi	SH R IH S T IY
limited	L IH M AH T AH D
limited(2)	L IH M IH T IH D
when	W EH N
when(2)	HH W EH N
when(3)	W IH N
when(4)	HH W IH N
rajasthan	R AH JH AE S TH AH N
i	AY
winston	W IH N S T AH N
nilkanth	N IH L K AH N TH
team	T IY M
kitchen	K IH CH AH N
signature	S IH G N AH CH ER
information	IH N F ER M EY SH AH N
information(2)	IH N F AO R M EY SH AH N
expect	IH K S P EH K T
wedding	W EH D IH NG
dining	D AY N IH NG
devotion	D IH V OW SH AH N
geyser	G AY Z ER
proprietor	P R AH P R AY AH T ER
manchester	M AE N CH EH S T ER
biotechnological	B AY OW T EH K N AH L AA JH IH K AH L
world	W ER L D
entertainment	EH N T ER T EY N M AH N T
entertainment(2)	EH N ER T EY N M AH N T
living	L IH V IH NG
refrigerator	R AH F R IH JH ER EY T ER
refrigerator(2)	R IH F R IH JH ER EY T ER
captivated	K AE P T IH V EY T IH D
affairs	AH F EH R Z
billionaires	B IH L Y AH N EH R Z
watch	W AA CH
watch(2)	W AO CH
exile	EH G Z AY L
exile(2)	EH K S AY L
languages	L AE NG G W AH JH AH Z
languages(2)	L AE NG G W IH JH IH Z
hvn	EY CH V IY N
stylers	S T AY L ER Z
iit	IY T
prachi	P R AE CH IY
happy	HH AE P IY
emporium	EH M P AO R IY AH M
premier	P R EH M IH R
premier(2)	P R IY M IH R
counter	K AW N T ER
karni	K AA R N IY
electronic	IH L EH K T R AA N IH K
buddy	B AH D IY
measures	M EH ZH ER Z
environmentalists	EH N V AY R AH N M EH N T AH L IH S T S
environmentalists(2)	EH N V AY R AH N M EH N AH L IH S T S
environmentalists(3)	EH N V AY R AH N M EH N T AH L IH S
environmentalists(4)	EH N V AY R AH N M EH N AH L IH S
buffett	B AH F IH T
vaibhav	V EY B HH AH V
vice	V AY S
source	S AO R S
saubhagyawati	S AO B HH AH JH AY AO AH T IY
javed	JH EY V D
afzhal	AH F ZH AH L
language	L AE NG G W AH JH
language(2)	L AE NG G W IH JH
laxmipati	L AE K S M IH P AH T IY
grow	G R OW
becomes	B IH K AH M Z
membership	M EH M B ER SH IH P
bank	B AE NG K
back	B AE K
lighting	L AY T IH NG
know	N OW
give	G IH V
another	AH N AH DH ER
soil	S OY L
cord	K AO R D
perfumes	P ER F Y UW M Z
women	W IH M AH N
quality	K W AA L AH T IY
children	CH IH L D R AH N
trader	T R EY D ER
officers	AO F AH S ER Z
officers(2)	AO F IH S ER Z
bring	B R IH NG
algorithms	AE L G ER IH DH AH M Z
exploring	IH K S P L AO R IH NG
glamourize	G L AE M ER AY Z
lollipop	L AA L IY P AA P
professional	P R AH F EH SH AH N AH L
is	IH Z
scientist	S AY AH N T IH S T
game	G EY M
craft	K R AE F T
alloy	AE L OY
something	S AH M TH IH NG
approach	AH P R OW CH
first	F ER S T
yogeshvar	Y AH JH EH SH V AH R
play	P L EY
commercialization	K AH M ER SH AH L IH Z EY SH AH N
motor	M OW T ER
action	AE K SH AH N
little	L IH T AH L
asian	EY ZH AH N
nice	N AY S
nice(2)	N IY S
spiritedness	S P IH R IH T IH D N AH S
wax	W AE K S
shlok	SH L AA K
manjari	M AE N JH AH R IY
trace	T R EY S
three	TH R IY
much	M AH CH
narendra	N AH R EH N D R AH
soldering	S AA D ER IH NG
field	F IY L D
africa	AE F R AH K AA
africa(2)	AE F R IH K AH
africa(3)	AE F ER K AH
africa(4)	AE F R IH K AA
geoid	JH IY OY D
got	G AA T
aptitude	AE P T AH T UW D
zoology	Z OW AA L AH JH IY
terrorists	T EH R ER AH S T S
terrorists(2)	T EH R ER IH S T S
telecom	T EH L AH K AA M
selections	S AH L EH K SH AH N Z
tasking	T AE S K IH NG
chandramouli	CH AE N D R AH M AW L IY
loose	L UW S
adventures	AE D V EH N CH ER Z
government	G AH V ER M AH N T
government(2)	G AH V ER N M AH N T
interest	IH N T R AH S T
interest(2)	IH N T R IH S T
interest(3)	IH N T ER AH S T
interest(4)	IH N T ER IH S T
interest(5)	IH N T AH R EH S T
factory	F AE K T ER IY
finders	F AY N D ER Z
gave	G EY V
as	AE Z
as(2)	EH Z
washing	W AA SH IH NG
gadgets	G AE JH AH T S
act	AE K T
ethzone	EH TH Z OW N
limit	L IH M AH T
finished	F IH N IH SH T
handicraft	HH AE N D IY K R AE F T
withholding	W IH TH HH OW L D IH NG
services	S ER V AH S AH Z
services(2)	S ER V IH S IH Z
decor	D IH K AO R
decor(2)	D EY K AO R
ias	AY AH Z
glass	G L AE S
universe	Y UW N AH V ER S
singh	S IH NG
fables	F EY B AH L Z
jhao	JH AW
body	B AA D IY
sari	S AA R IY
toy	T OY
unconstitutionally	AH N K AA N S T AH T UW SH AH N AH L IY
unconstitutionally(2)	AH N K AA N S T AH T UW SH N AH L IY
microprocessors	M AY K R OW P R AA S EH S ER Z
sadhguru	S AE D HH G Y AH R UW
dynamics	D AY N AE M IH K S
your	Y AO R
your(2)	Y UH R
against	AH G EH N S T
against(2)	AH G EY N S T
hitler	HH IH T L ER
rules	R UW L Z
sympathetic	S IH M P AH TH EH T IH K
disciplinary	D IH S AH P L AH N EH R IY
kiyara	K AY AY AH R AH
employment	EH M P L OY M AH N T
employment(2)	IH M P L OY M AH N T
gemstone	JH EH M S T OW N
attacking	AH T AE K IH NG
seat	S IY T
became	B IH K EY M
became(2)	B IY K EY M
jupiter	JH UW P AH T ER
jupiter(2)	JH UW P IH T ER
research	R IY S ER CH
nutrition	N UW T R IH SH AH N
hanuman	HH AE N Y UW M AH N
handicrafts	HH AE N D IY K R AE F T S
wristband	R IH S T B AE N D
university	Y UW N AH V ER S AH T IY
poetry	P OW AH T R IY
wine	W AY N
went	W EH N T
medical	M EH D AH K AH L
medical(2)	M EH D IH K AH L
corporation	K AO R P ER EY SH AH N
albums	AE L B AH M Z
king	K IH NG
harrison	HH EH R IH S AH N
mission	M IH SH AH N
woman	W UH M AH N
sense	S EH N S
police	P AH L IY S
extra	EH K S T R AH
perfect	P ER F EH K T
perfect(2)	P ER F IH K T
sausage	S AO S AH JH
sausage(2)	S AO S IH JH
divine	D IH V AY N
magnet	M AE G N AH T
straight	S T R EY T
xtreme	Z T R IY M
realism	R IY AH L IH Z M
able	EY B AH L
curricular	K ER IH K Y AH L ER
equipment	IH K W IH P M AH N T
technologies	T EH K N AA L AH JH IY Z
textile	T EH K S T AY L
siddhi	S IH D HH IY
firearms	F AY ER AA R M Z
firearms(2)	F AY R AA R M Z
course	K AO R S
bbc	B IY B IY S IY
classique	K L AE S AH K
gulzar	G AH L Z AH R
differential	D IH F ER EH N SH AH L
wonderful	W AH N D ER F AH L
presario	P R IH S AA R IY OW
udyog	Y UW D AY AH G
around	ER AW N D
around(2)	ER AW N
into	IH N T UW
into(2)	IH N T AH
urdu	ER D UW
goggles	G AA G AH L Z
songs	S AO NG Z
times	T AY M Z
highly	HH AY L IY
hypersensitivity	HH AY P ER S EH N S IH T IH V IH T IY
salwar	S AH L W AA R
salwar(2)	S AE L W AH R
controversial	K AA N T R AH V ER SH AH L
lolly	L AA L IY
load	L OW D
then	DH EH N
subconscious	S AH B K AA N SH AH S
yourself	Y ER S EH L F
yourself(2)	Y UH R S EH L F
yourself(3)	Y AO R S EH L F
stock	S T AA K
thesaurus	TH AH S AO R AH S
barbie	B AA R B IY
homoeopathy	HH AA M OW EH AA P AH TH IY
access	AE K S EH S
educational	EH JH AH K EY SH AH N AH L
educational(2)	EH JH Y UW K EY SH AH N AH L
ten	T EH N
leggings	L EH G IH NG Z
height	HH AY T
stone	S T OW N
photo	F OW T OW
walter	W AO L T ER
harihar	HH AE R AH AH R
makers	M EY K ER Z
private	P R AY V AH T
best	B EH S T
stereo	S T EH R IY OW
great	G R EY T
net	N EH T
mumbai	M UH M B AY
semiconductors	S EH M IY K AH N D AH K T ER Z
semiconductors(2)	S EH M IH K AH N D AH K T ER Z
semiconductors(3)	S EH M AY K AH N D AH K T ER Z
wise	W AY Z
oysters	OY S T ER Z
tyre	T AY R
secrets	S IY K R AH T S
secrets(2)	S IY K R IH T S
self	S EH L F
pieces	P IY S AH Z
pieces(2)	P IY S IH Z
tourism	T UH R IH Z AH M
kanoi	K AE N OY
heaters	HH IY T ER Z
quantitative	K W AA N T IH T EY T IH V
papers	P EY P ER Z
ganesh	G AE N AH SH
products	P R AA D AH K T S
products(2)	P R AA D AH K S
devices	D IH V AY S AH Z
devices(2)	D IH V AY S IH Z
choong	CH UW NG
more	M AO R
day	D EY
manekeshaw	M AE N IY K SH AO
catholicism	K AH TH AO L AH S IH Z AH M
tails	T EY L Z
mughal	M AH AH L
international	IH N T ER N AE SH AH N AH L
international(2)	IH N ER N AE SH AH N AH L
international(3)	IH N T ER N AE SH AH N AA L
international(4)	IH N ER N AE SH AH N AA L
save	S EY V
ss	EH S
ghee	G IY
player	P L EY ER
ramnath	R AE M N AH TH
room	R UW M
oyster	OY S T ER
paperback	P EY P ER B AE K
stelzner	S T EH L Z N ER
secondary	S EH K AH N D EH R IY
t	T IY
jee	JH IY
gloves	G L AH V Z
cholis	CH OW L AH S
prince	P R IH N S
heater	HH IY T ER
clothings	K L OW DH IH NG Z
tshirt	T SH AH R T
retailers	R IY T EY L ER Z
operations	AA P ER EY SH AH N Z
lubricant	L UW B R AH K AH N T
scientific	S AY AH N T IH F IH K
will	W IH L
will(2)	W AH L
gourmet	G UH R M EY
ignou	IH G N UW
every	EH V ER IY
every(2)	EH V R IY
network	N EH T W ER K
too	T UW
khushi	K HH AH SH IY
tribal	T R AY B AH L
taxes	T AE K S AH Z
taxes(2)	T AE K S IH Z
guard	G AA R D
ineffectiveness	IH N AH F EH K T IH V N AH S
selected	S AH L EH K T IH D
selected(2)	S AH L EH K T AH D
delineations	D IY L IH N IY EY SH AH N Z
avani	AE V AH N IY
ultimate	AH L T AH M AH T
flashing	F L AE SH IH NG
colors	K AH L ER Z
yashna	Y AE SH N AH
rhymes	R AY M Z
outdoors	AW T D AO R Z
outdoors(2)	AW T D OW R S
shop	SH AA P
handiweaves	HH AE N D AH W IY V Z
privileged	P R IH V L AH JH D
privileged(2)	P R IH V L IH JH D
privileged(3)	P R IH V IH L AH JH D
privileged(4)	P R IH V IH L IH JH D
health	HH EH L TH
evolution	EH V AH L UW SH AH N
evolution(2)	IY V AH L UW SH AH N
evolution(3)	EH V OW L UW SH AH N
evolution(4)	IY V OW L UW SH AH N
automatic	AO T AH M AE T IH K
automatic(2)	AO T OW M AE T IH K
implementing	IH M P L AH M EH N T IH NG
implementing(2)	IH M P L AH M EH N IH NG
shock	SH AA K
kim	K IH M
vocabulary	V OW K AE B Y AH L EH R IY
martin	M AA R T AH N
martin(2)	M AA R T IH N
ethics	EH TH IH K S
removers	R IY M UW V ER Z
master	M AE S T ER
gmat	G M AE T
blue	B L UW
mystery	M IH S T ER IY
zone	Z OW N
nine	N AY N
inch	IH N CH
shivam	SH IH V AH M
dental	D EH N T AH L
dental(2)	D EH N AH L
compaq	K AA M P AE K
individualistic	IH N D IH V IH JH UW AH L IH S T IH K
needs	N IY D Z
pottery	P AA T ER IY
ssc	EH S EH S K
superintendents	S UW P ER AH N T EH N D AH N T S
superintendents(2)	S UW P ER IH N T EH N D AH N T S
personality	P ER S AH N AE L IH T IY
awareness	AH W EH R N AH S
expecting	IH K S P EH K T IH NG
forty	F AO R T IY
personification	P ER S AA N AH F AH K EY SH AH N
panchayati	P AE NG K EY AH T IY
pre	P R IY
modernism	M AA D ER N IH Z AH M
paramount	P EH R AH M AW N T
modi	M OW D IY
tv	T IY V IY
tv(2)	T EH L AH V IH ZH AH N
lovely	L AH V L IY
won	W AH N
won(2)	W AA N
architecturally	AA R K IH T EH K CH ER AH L IY
architecturally(2)	AA R K IH T EH K CH R AH L IY
verb	V ER B
headline	HH EH D L AY N
tools	T UW L Z
studio	S T UW D IY OW
management	M AE N AH JH M AH N T
management(2)	M AE N IH JH M AH N T
cherry	CH EH R IY
law	L AO
law(2)	L AA
festive	F EH S T IH V
daily	D EY L IY
swallowed	S W AA L OW D
kolhapuri	K OW L HH AE P Y AH R IY
bestprice	B EH S T P R AY S
taped	T EY P T
garments	G AA R M AH N T S
multimedia	M AH L T IY M IY D IY AH
multimedia(2)	M AH L T AY M IY D IY AH
bright	B R AY T
analog	AE N AH L AO G
samsung	S AE M S AH NG
collections	K AH L EH K SH AH N Z
massage	M AH S AA ZH
science	S AY AH N S
test	T EH S T
supplies	S AH P L AY Z
bags	B AE G Z
books	B UH K S
god	G AA D
pad	P AE D
colored	K AH L ER D
cardio	K AA R D IY OW
navel	N EY V AH L
ready	R EH D IY
ordinary	AO R D AH N EH R IY
value	V AE L Y UW
learning	L ER N IH NG
techpoint	T EH K OY N T
earbuds	IH ER B AH D Z
housewife	HH AW S W AY F
characterizations	K EH R AH K T ER IH Z EY SH AH N Z
mainak	M EY N AH K
statistics	S T AH T IH S T IH K S
people	P IY P AH L
of	AH V
unknown	AH N N OW N
good	G UH D
good(2)	G IH D
need	N IY D
higher	HH AY ER
distributorship	D IH S T R IH B Y UW T ER SH IH P
gaming	G EY M IH NG
om	AO M
gre	G AH R
pioneer	P AY AH N IH R
industries	IH N D AH S T R IY Z
area	EH R IY AH
reference	R EH F ER AH N S
reference(2)	R EH F R AH N S
containers	K AH N T EY N ER Z
administrative	AH D M IH N AH S T R EY T IH V
administrative(2)	AH D M IH N IH S T R EY T IH V
pocket	P AA K AH T
shreenathji	SH R IY N AE TH JH IY
managing	M AE N AH JH IH NG
career	K ER IH R
silent	S AY L AH N T
meditation	M EH D AH T EY SH AH N
shree	SH R IY
kindergarten	K IH N D ER G AA R T AH N
think	TH IH NG K
karan	K EH R AH N
usb	Y UW EH S B IY
usb(2)	AH Z
weaver	W IY V ER
cushion	K UH SH AH N
worlds	W ER L D Z
boy	B OY
gandhi	G AA N D IY
zofey	Z OW F IY
worthiness	W ER DH IY N IH S
kanchana	K AE NG K AH N AH
post	P OW S T
ignorance	IH G N ER AH N S
vintage	V IH N T IH JH
nano	N AA N OW
nano(2)	N AE N OW
silk	S IH L K
tragedy	T R AE JH AH D IY
corner	K AO R N ER
materials	M AH T IH R IY AH L Z
thrillers	TH R IH L ER Z
cbse	K B S
wife	W AY F
do	D UW
smarter	S M AA R T ER
clock	K L AA K
encourage	EH N K ER IH JH
encourage(2)	IH N K ER AH JH
what	W AH T
what(2)	HH W AH T
dryer	D R AY ER
marketing	M AA R K AH T IH NG
piyush	P AY AY AH SH
bottles	B AA T AH L Z
hindi	HH IH N D IY
satish	S AE T IH SH
plaza	P L AA Z AH
plaza(2)	P L AE Z AH
youths	Y UW DH Z
youths(2)	Y UW TH S
behaviour	B IH HH EY V Y ER
explosive	IH K S P L OW S IH V
cameras	K AE M ER AH Z
cameras(2)	K AE M R AH Z
trading	T R EY D IH NG
trigonometry	T R IH G AH N AH M EH T R IY
where	W EH R
where(2)	HH W EH R
edible	EH D AH B AH L
furnitures	F ER N IH CH ER Z
principle	P R IH N S AH P AH L
lifestyle	L AY F S T AY L
nda	N D AA
lehenga	L AH HH EH N G AH
points	P OY N T S
life	L AY F
effect	IH F EH K T
effect(2)	IY F EH K T
effect(3)	AH F EH K T
grandfather	G R AE N D F AA DH ER
grandfather(2)	G R AE N F AA DH ER
axelson	AE K S IH L S AH N
names	N EY M Z
year	Y IH R
nature	N EY CH ER
nature(2)	N EY CH AH R
making	M EY K IH NG
economics	EH K AH N AA M IH K S
economics(2)	IY K AH N AA M IH K S
linear	L IH N IY ER
full	F UH L
being	B IY IH NG
below	B IH L OW
below(2)	B IY L OW
state	S T EY T
patterns	P AE T ER N Z
promotional	P R AH M OW SH AH N AH L
promotional(2)	P ER M OW SH AH N AH L
pratiyogita	P R EY T IY AY AA JH AH T AH
inspiring	IH N S P AY R IH NG
inspiring(2)	IH N S P AY ER IH NG
sightedness	S AY T AH D N AH S
narmadeshwar	N AA R M AH D EH SH W AH R
uttam	AH T AH M
everlasting	EH V ER L AE S T IH NG
essential	EH S EH N SH AH L
essential(2)	IY S EH N SH AH L
new	N UW
new(2)	N Y UW
change	CH EY N JH
theory	TH IH R IY
theory(2)	TH IY ER IY
diaries	D AY ER IY Z
diaries(2)	D AY R IY Z
let	L EH T
ultra	AH L T R AH
vivacity	V AH V AE S AH T IY
ignore	IH G N AO R
shyam	SH AY AH M
peripherals	P ER IH F ER AH L Z
peripherals(2)	P ER IH F R AH L Z
long	L AO NG
vikram	V IH K R AH M
agricultural	AE G R AH K AH L CH ER AH L
agricultural(2)	AE G R IH K AH L CH ER AH L
unrealistically	AH N R IY AH L IH S T IH K L IY
reebok	R IY B AA K
car	K AA R
indian	IH N D IY AH N
fulfil	F UH L F IH L
fulfil(2)	F UH L F AH L
william	W IH L Y AH M
magnetism	M AE G N AH T IH Z AH M
iphone	AY F OW N
fashions	F AE SH AH N Z
exchange	IH K S CH EY N JH
museum	M Y UW Z IY AH M
fuel	F Y UW AH L
fuel(2)	F Y UW L
just	JH AH S T
just(2)	JH IH S T
psychotherapy	S AY K OW TH EH R AH P IY
crown	K R AW N
use	Y UW S
use(2)	Y UW Z
prayer	P R EH R
prayer(2)	P R EY ER
introduction	IH N T R AH D AH K SH AH N
introduction(2)	IH N T R OW D AH K SH AH N
lost	L AO S T
jumbo	JH AH M B OW
attractions	AH T R AE K SH AH N Z
competitiveness	K AH M P EH T IH T IH V N IH S
charm	CH AA R M
half	HH AE F
jackets	JH AE K IH T S
therapeutics	TH EH R AH P Y UW T IH K S
masala	M AH S AA L AA
masala(2)	M AE S AH L AH
olympiad	OW L IH M P IY AE D
hd	EH CH D IY
gifts	G IH F T S
gifts(2)	G IH F S
mumbaistan	M AH M B EY Z T AE N
tracker	T R AE K ER
data	D EY T AH
data(2)	D AE T AH
cards	K AA R D Z
verbal	V ER B AH L
creations	K R IY EY SH AH N Z
deoxy	D IY AA K S IY
aditya	AH D IH T AY AH
hospitality	HH AA S P AH T AE L AH T IY
so	S OW
dung	D AH NG
rangeelo	R AE N JH IY L OW
public	P AH B L IH K
arihant	AE R AH AH N T
help	HH EH L P
case	K EY S
paper	P EY P ER
it	IH T
junior	JH UW N Y ER
camping	K AE M P IH NG
positive	P AA Z AH T IH V
ophthalmologists	AA P TH AH M AA L AH JH IH S T S
ophthalmologists(2)	AA P TH AH M AA L AH JH IH S
ophthalmologists(3)	AA F TH AH M AA L AH JH IH S T S
ophthalmologists(4)	AA F TH AH M AA L AH JH IH S
mother	M AH DH ER
changer	CH EY N JH ER
irons	AY ER N Z
fitness	F IH T N AH S
java	JH AA V AH
heritage	HH EH R AH T AH JH
heritage(2)	HH EH R IH T IH JH
earring	IH R IH NG
earring(2)	IY R IH NG
items	AY T AH M Z
speaker	S P IY K ER
shortsightedness	SH AO R T S AY T IH D N IH S
chinese	CH AY N IY Z
plans	P L AE N Z
struggling	S T R AH G AH L IH NG
struggling(2)	S T R AH G L IH NG
navyata	N AH V AY AH T AH
letters	L EH T ER Z
comprehension	K AA M P R IY HH EH N SH AH N
personal	P ER S IH N AH L
pullover	P UH L OW V ER
rods	R AA D Z
jewellery	JH UW AH L AH R IY
future	F Y UW CH ER
lightheadedness	L AY T HH EH D AH D N AH S
onida	AA N AH D AH
trade	T R EY D
picture	P IH K CH ER
india	IH N D IY AH
thousand	TH AW Z AH N D
thousand(2)	TH AW Z AH N
price	P R AY S
can	K AE N
can(2)	K AH N
shake	SH EY K
school	S K UW L
cooking	K UH K IH NG
cluse	K L UW Z
hidden	HH IH D AH N
tours	T UH R Z
tours(2)	T AO R Z
manufacturing	M AE N Y AH F AE K CH ER IH NG
scratch	S K R AE CH
rock	R AA K
maharaja	M AA HH ER AA ZH AH
gaubert	G AW B ER T
gaubert(2)	G AW B EH R T
boys	B OY Z
garage	G ER AA ZH
examples	IH G Z AE M P AH L Z
sweater	S W EH T ER
choose	CH UW Z
theories	TH IH R IY Z
theories(2)	TH IY ER IY Z
to	T UW
to(2)	T IH
to(3)	T AH
cooper	K UW P ER
apple	AE P AH L
sultan	S AH L T AH N
oil	OY L
digital	D IH JH AH T AH L
digital(2)	D IH JH IH T AH L
bharti	B HH AA R T IY
soup	S UW P
unicon	Y UW N IH K AA N
skateboards	S K EY T B OW R D Z
leadership	L IY D ER SH IH P
proliferation	P R OW L IH F ER EY SH AH N
perspective	P ER S P EH K T IH V
conferencing	K AA N F R AH N S IH NG
he	HH IY
bracelet	B R EY S L AH T
selection	S AH L EH K SH AH N
illumination	IH L UW M AH N EY SH AH N
workbook	W ER K B UH K
gopal	G OW P AA L
cardiograms	K AA R D IY AA G R AH M Z
audio	AA D IY OW
glossy	G L AO S IY
doctor	D AA K T ER
doctor(2)	D AO K T ER
habits	HH AE B AH T S
fabrics	F AE B R IH K S
intelligence	IH N T EH L AH JH AH N S
cloth	K L AO TH
amma	AE M AH
attractive	AH T R AE K T IH V
weapons	W EH P AH N Z
empire	EH M P AY ER
spanish	S P AE N IH SH
gear	G IH R
disorganization	D IH S AO R G AH N AH Z EY SH AH N
aastha	AA S TH AH
nayan	N EY AH N
ribonucleic	R AY B OW N UW K L EY IH K
rests	R EH S T S
love	L AH V
lakshmi	L AE K M IY
not	N AA T
radio	R EY D IY OW
donated	D OW N EY T IH D
mall	M AO L
memory	M EH M ER IY
royal	R OY AH L
furniture	F ER N IH CH ER
fashion	F AE SH AH N
pragati	P R AE G AH T IY
cortico	K AA R T IH K OW
behind	B IH HH AY N D
pharmaceutical	F AA R M AH S UW T IH K AH L
a	AH
a(2)	EY
valuation	V AE L Y UW EY SH AH N
our	AW ER
our(2)	AW R
our(3)	AA R
accessories	AE K S EH S ER IY Z
appointment	AH P OY N T M AH N T
jewelery	JH UW AH L AH R IY
leather	L EH DH ER
zenfone	Z EH N F OW N
examinations	IH G Z AE M AH N EY SH AH N Z
very	V EH R IY
cab	K AE B
urban	ER B AH N
powereye	P AW ER AY
jai	JH AY
jai(2)	HH AY
fully	F UH L IY
analysis	AH N AE L AH S AH S
analysis(2)	AH N AE L IH S IH S
analysis(3)	AE N AE L IH S IH S
graphic	G R AE F IH K
were	W ER
generational	JH EH N ER EY SH AH N AH L
ravi	R AA V IY
model	M AA D AH L
discography	D IH S K AO G R AH F IY
sector	S EH K T ER
electronics	IH L EH K T R AA N IH K S
sitaram	S IH T AH R AE M
shape	SH EY P
deal	D IY L
sapna	S AE P N AH
algebra	AE L JH AH B R AH
ugc	AH G K
poly	P AA L IY
sound	S AW N D
ibm	AY B IY EH M
ibm(2)	IH B M
bhaang	B HH AA NG
smartwatch	S M AA R T W AA CH
platinum	P L AE T N AH M
platinum(2)	P L AE T AH N AH M
power	P AW ER
power(2)	P AO W AH R
conceptualization	K AH N S EH P CH W AH L IH Z EY SH AH N
engineer	EH N JH AH N IH R
styling	S T AY L IH NG
vidyapati	V IH D AY AE P AH T IY
camera	K AE M ER AH
camera(2)	K AE M R AH
rainbow	R EY N B OW
array	ER EY
fair	F EH R
style	S T AY L
easy	IY Z IY
looks	L UH K S
problems	P R AA B L AH M Z
protectors	P R AH T EH K T ER Z
milkha	M IH L K AH
bmr	B IY EH M R
villa	V IH L AH
tyres	T AY ER Z
tyres(2)	T AY R Z
morpankh	M AO R P AH NG K
wheel	W IY L
wheel(2)	HH W IY L
create	K R IY EY T
jhakir	ZH AA K IH R
industrial	IH N D AH S T R IY AH L
kiran	K AY R AH N
gas	G AE S
average	AE V ER IH JH
average(2)	AE V R AH JH
average(3)	AE V R IH JH
organisational	AO R G AH N IY Z EY SH AH N AH L
consciousness	K AA N SH AH S N AH S
complete	K AH M P L IY T
basket	B AE S K AH T
panasonic	P AE N AH S AA N IH K
up	AH P
star	S T AA R
lakshya	L AE K AY AH
old	OW L D
chance	CH AE N S
friends	F R EH N D Z
friends(2)	F R EH N Z
odds	AA D Z
jto	JH T OW
centimeter	S EH N T AH M IY T ER
priority	P R AY AO R AH T IY
studies	S T AH D IY Z
under	AH N D ER
mastering	M AE S T ER IH NG
butterflies	B AH T ER F L AY Z
auto	AO T OW
box	B AA K S
van	V AE N
exports	EH K S P AO R T S
frames	F R EY M Z
kumar	K UW M AA R
dvd	D IY V IY D IY
pitfalls	P IH T F AO L Z
sets	S EH T S
early	ER L IY
whatever	W AH T EH V ER
whatever(2)	HH W AH T EH V ER
music	M Y UW Z IH K
swastik	S W AA S T AH K
minister	M IH N AH S T ER
minister(2)	M IH N IH S T ER
and	AH N D
and(2)	AE N D
company	K AH M P AH N IY
has	HH AE Z
has(2)	HH AH Z
video	V IH D IY OW
wheeler	W IY L ER
wheeler(2)	HH W IY L ER
governmental	G AH V ER M EH N T AH L
governmental(2)	G AH V ER N M EH N T AH L
exclamation	EH K S K L AH M EY SH AH N
delhi	D EH L IY
generic	JH AH N EH R IH K
explorations	EH K S P L ER EY SH AH N Z
explorations(2)	EH K S P L AO R EY SH AH N Z
communications	K AH M Y UW N AH K EY SH AH N Z
mischaracterizing	M IH S K AE R AH K T ER AY Z IH NG
mtg	EH M T IY G
alpha	AE L F AH
musketeers	M AH S K AH T IY R Z
moylee	M OY L IY
aaykay	AA IH K EY IY
curve	K ER V
column	K AA L AH M
improvement	IH M P R UW V M AH N T
thinking	TH IH NG K IH NG
replicating	R EH P L IH K EY T IH NG
direct	D ER EH K T
direct(2)	D AY R EH K T
direct(3)	D IH R EH K T
chemotherapy	K IY M OW TH EH R AH P IY
wealth	W EH L TH
surat	S ER AA T
clearance	K L IH R AH N S
have	HH AE V
warrior	W AO R IY ER
warrior(2)	W AO R Y ER
harry	HH EH R IY
success	S AH K S EH S
ripper	R IH P ER
fall	F AO L
fall(2)	F AA L
general	JH EH N ER AH L
general(2)	JH EH N R AH L
mills	M IH L Z
activities	AE K T IH V AH T IY Z
activities(2)	AE K T IH V IH T IY Z
loyola	L OY OW L AH
objective	AH B JH EH K T IH V
cotton	K AA T AH N
cotton(2)	K AO T AH N
dresses	D R EH S AH Z
dresses(2)	D R EH S IH Z
this	DH IH S
drenched	D R EH N CH T
vsm	V IY EH S M
outdoor	AW T D AO R
undersubscribed	AH N D ER S AH B S K R AY B D
fit	F IH T
vardhman	V AA R D HH M AH N
poems	P OW AH M Z
two	T UW
baba	B AH B AH
baba(2)	B AA B AH
bucket	B AH K AH T
bucket(2)	B AH K IH T
here	HH IY R
machine	M AH SH IY N
essence	EH S AH N S
animation	AE N AH M EY SH AH N
coat	K OW T
shoes	SH UW Z
retail	R IY T EY L
dimensional	D IH M EH N SH AH N AH L
madhubala	M AE D HH Y UW B AH L AH
them	DH EH M
them(2)	DH AH M
spectacles	S P EH K T AH K AH L Z
investment	IH N V EH S T M AH N T
investment(2)	IH N V EH S M AH N T
multifunctional	M AH L T IY F AH NG K SH AH N AH L
ramdev	R AE M D AH V
textiles	T EH K S T AY L Z
complaint	K AH M P L EY N T
graph	G R AE F
national	N AE SH AH N AH L
national(2)	N AE SH N AH L
regional	R IY JH AH N AH L
aviator	EY V IY EY T ER
had	HH AE D
shayona	SH EY AH N AH
misapprehension	M IH S AE P R IY HH EH N SH AH N
journalist	JH ER N AH L AH S T
journalist(2)	JH ER N AH L IH S T
set	S EH T
n	EH N
mister	M IH S T ER
reasoning	R IY Z AH N IH NG
pilot	P AY L AH T
tvs	T IY V IY Z
ambassadorships	AE M B AE S AH D ER SH IH P S
showers	SH AW ER Z
years	Y IH R Z
years(2)	Y ER Z
dauphin	D AW F IH N
demystifying	D IY M IH S T AH F AY IH NG
balaji	B AE L AH JH IY
rabbit	R AE B AH T
rabbit(2)	R AE B IH T
round	R AW N D
indianwear	IH N D AY AE N W IY AH R
spirituality	S P IH R IH CH UW AE L AH T IY
accessory	AE K S EH S ER IY
determination	D IH T ER M AH N EY SH AH N
enjoy	EH N JH OY
enjoy(2)	IH N JH OY
four	F AO R
trendy	T R EH N D IY
autobiography	AO T AH B AY AA G R AH F IY
sports	S P AO R T S
shopper	SH AA P ER
vishweshwara	V IH SH W EH SH W AH R AH
galleria	G AE L ER IY AH
solid	S AA L AH D
shopping	SH AA P IH NG
taliban	T AE L IH B AE N
everything	EH V R IY TH IH NG
manyata	M AH N AY AH T AH
john	JH AA N
reputed	R IH P Y UW T IH D
reputed(2)	R IY P Y UW T IH D
anaesthesiologists	AE N AH S TH IY Z IY AA L AH JH IH S T S
ayodhya	AY AA D Y AH
ed	EH D
mind	M AY N D
century	S EH N CH ER IY
bindass	B AY N D AE S
taxi	T AE K S IY
sixth	S IH K S TH
bearers	B EH R ER Z
both	B OW TH
things	TH IH NG Z
equations	IH K W EY ZH AH N Z
tagore	T AE G OW R
fortune	F AO R CH AH N
fortune(2)	F AO R CH UW N
musicologist	M Y UW Z IH K AA L AH JH AH S T
don	D AA N
we	W IY
counseling	K AW N S AH L IH NG
counseling(2)	K AW N S L IH NG
chhabra	CH HH AE B R AH
wallet	W AO L AH T
sunday	S AH N D EY
sunday(2)	S AH N D IY
uber	UW B ER
uber(2)	Y UW B ER
enterprises	EH N T ER P R AY Z IH Z
enterprises(2)	EH N ER P R AY Z IH Z
genius	JH IY N Y AH S
princess	P R IH N S EH S
ritualistically	R IH CH UW AH L IH S T IH K AH L IY
ritualistically(2)	R IH CH UW AH L IH S T IH K L IY
ishita	IH SH AH T AH
ahuja	AA HH UW Y AH
maharashtra	M AA HH ER AA SH T R AH
roy	R OY
checker	CH EH K ER
enterprise	EH N T ER P R AY Z
enterprise(2)	EH N ER P R AY Z
spike	S P AY K
mukhopadhyay	M UW K OW P AA D Y AY
zhang	ZH AE NG
zhang(2)	ZH AA NG
work	W ER K
galaxy	G AE L AH K S IY
rural	R UH R AH L
gun	G AH N
monica	M AA N IH K AH
high	HH AY
flower	F L AW ER
phrases	F R EY Z AH Z
phrases(2)	F R EY Z IH Z
indians	IH N D IY AH N Z
you	Y UW
review	R IY V Y UW
lose	L UW Z
child	CH AY L D
deep	D IY P
guards	G AA R D Z
chehaks	CH EH HH AH K S
rakesh	R AE K AH SH
rakesh(2)	R AA K EY SH
sheesha	SH IY SH AH
museums	M Y UW Z IY AH M Z
kids	K IH D Z
shivling	SH AY V L AH NG
stretcher	S T R EH CH ER
together	T AH G EH DH ER
energizing	EH N ER JH AY Z IH NG
junction	JH AH NG K SH AH N
anglo	AE NG G L OW
favourite	F EY V ER IH T
eighty	EY T IY
foot	F UH T
healthcare	HH EH L TH K EH R
bedroom	B EH D R UW M
mala	M AA L AH
chawla	CH AO L AH
dreams	D R IY M Z
makes	M EY K S
valve	V AE L V
lights	L AY T S
read	R EH D
read(2)	R IY D
education	EH JH AH K EY SH AH N
education(2)	EH JH Y UW K EY SH AH N
card	K AA R D
bsnl	B IY EH S EH N L
suit	S UW T
fiction	F IH K SH AH N
georgette	JH AO R JH EH T
there	DH EH R
almanac	AA L M AH N AE K
wrench	R EH N CH
bio	B AY OW
handi	HH AE N D IY
milk	M IH L K
traders	T R EY D ER Z
water	W AO T ER
challenges	CH AE L AH N JH IH Z
truth	T R UW TH
after	AA F T ER
after(2)	AE F T ER
riding	R AY D IH NG
knockout	N AA K AW T
guidebook	G AY D B UH K
pampers	P AE M P ER Z
blinky	B L IH NG K IY
credit	K R EH D AH T
credit(2)	K R EH D IH T
javascript	JH AA V AH S K R IH P T
ceo	S IY IY OW
beautiful	B Y UW T AH F AH L
alcohol	AE L K AH HH AA L
food	F UW D
handloom	HH AE N D L UW M
mens	M EH N Z
savaliya	S AE V AH L IY AY AH
decentralization	D IH S EH N T R AH L IH Z EY SH AH N
computer	K AH M P Y UW T ER
crypto	K R IH P T OW
sunglasses	S AH N G L AE S IH Z
czechoslovakia	CH EH K AH S L OW V AA K IY AH
television	T EH L AH V IH ZH AH N
analogue	AE N AH L AO G
buy	B AY
addiction	AH D IH K SH AH N
click	K L IH K
cellularly	S EH L Y AH L ER L IY
ios	IY OW S
ios(2)	AY OW S
bhagwati	B HH AE G W AH T IY
tempered	T EH M P ER D
tell	T EH L
buyers	B AY ER Z
mini	M IH N IY
current	K ER AH N T
current(2)	K ER N T
current(3)	K AA R AH N T
develop	D IH V EH L AH P
about	AH B AW T
pulmonary	P UH L M AH N EH R IY
training	T R EY N IH NG
withstanding	W IH TH S T AE N D IH NG
choreographing	K AO R IY AA G R AH F IH NG
choreographing(2)	K AO R IY AH G R AE F IH NG
death	D EH TH
exporter	IH K S P AO R T ER
maa	M AA
casual	K AE ZH AH W AH L
casual(2)	K AE ZH W AH L
seekers	S IY K ER Z
imaging	IH M IH JH IH NG
five	F AY V
eyewear	AY W EH R
hanging	HH AE NG IH NG
hanging(2)	HH AE NG G IH NG
mahaveer	M AE HH AH V IH R
govind	G AH V AY N D
busy	B IH Z IY
killing	K IH L IH NG
an	AE N
an(2)	AH N
massaged	M AH S AA ZH D
dth	D IY T IY AE CH
dth(2)	D IY T IY
build	B IH L D
official	AH F IH SH AH L
household	HH AW S HH OW L D
or	AO R
or(2)	ER
creation	K R IY EY SH AH N
powerful	P AW ER F AH L
conservative	K AH N S ER V AH T IH V
her	HH ER
history	HH IH S T ER IY
history(2)	HH IH S T R IY
excellent	EH K S AH L AH N T
para	P EH R AH
through	TH R UW
resourcefulness	R IY S AO R S F AH L N AH S
wrong	R AO NG
adolf	EY D AA L F
tipu	T IH P UW
fluid	F L UW AH D
fluid(2)	F L UW IH D
surge	S ER JH
lcd	EH L S IY D
generated	JH EH N ER EY T AH D
generated(2)	JH EH N ER EY T IH D
why	W AY
why(2)	HH W AY
dolls	D AA L Z
megamart	M EH G AH M AH R T
live	L AY V
live(2)	L IH V
pinnacle	P IH N AH K AH L
innovation	IH N AH V EY SH AH N
innovation(2)	IH N OW V EY SH AH N
for	F AO R
for(2)	F ER
for(3)	F R ER
north	N AO R TH
prints	P R IH N T S
cyber	S AY B ER
housekeeping	HH AW S K IY P IH NG
doodle	D UW D AH L
regardless	R AH G AA R D L AH S
victory	V IH K T ER IY
victory(2)	V IH K T R IY
victory(3)	V IH K T AH R IY
movie	M UW V IY
online	AO N L AY N
quantum	K W AA N T AH M
bindra	B AY N D R AA
internal	IH N T ER N AH L
zoom	Z UW M
vedant	V IY D AH N T
catch	K AE CH
chocolate	CH AO K L AH T
chemicals	K EH M IH K AH L Z
pseudo	S UW D OW
meteorologist	M IY T IY ER AA L AH JH IH S T
companies	K AH M P AH N IY Z
fusion	F Y UW ZH AH N
led	L EH D
ever	EH V ER
me	M IY
expressions	IH K S P R EH SH AH N Z
eyeglasses	AY G L AE S AH Z
eyeglasses(2)	AY G L AE S IH Z
celebration	S EH L AH B R EY SH AH N
choice	CH OY S
transferable	T R AE N S F ER AH B AH L
necklaces	N EH K L AH S IH Z
chowky	CH AW K IY
physics	F IH Z IH K S
his	HH IH Z
gold	G OW L D
luther	L UW TH ER
creative	K R IY EY T IH V
games	G EY M Z
tele	T EH L IY
tele(2)	T EH L AH
neck	N EH K
founder	F AW N D ER
wants	W AA N T S
wants(2)	W AO N T S
backpacks	B AE K P AE K S
biology	B AY AA L AH JH IY
bijoy	B IH JH OY
offer	AO F ER
smart	S M AA R T
pearson	P IH R S AH N
ethnic	EH TH N IH K
tablet	T AE B L AH T
beyond	B IH AA N D
beyond(2)	B IY AO N D
beyond(3)	B IH AO N D
party	P AA R T IY
optical	AA P T IH K AH L
warren	W AO R AH N
book	B UH K
increase	IH N K R IY S
jam	JH AE M
varieties	V ER AY AH T IY Z
surva	S AH R V AH
paridhi	P AH R IH D HH IY
compartmentalized	K AA M P AA R T M EH N T AH L AY Z D
pacific	P AH S IH F IH K
report	R IY P AO R T
report(2)	R IH P AO R T
misidentification	M IH S AY D EH N T IH F IH K EY SH AH N
misidentification(2)	M IH S AY D EH N IH F IH K EY SH AH N
multi	M AH L T IY
ground	G R AW N D
supply	S AH P L AY
supply(2)	S AH P L AA IH
supply(3)	S AH P L AA IY
skin	S K IH N
given	G IH V AH N
given(2)	G IH V IH N
pathfinder	P AE TH F AY N D ER
house	HH AW S
tommy	T AA M IY
absorbers	AH B Z AO R B ER Z
furnishing	F ER N IH SH IH NG
espionage	EH S P IY AH N AA JH
surdas	S AH R D AH Z
skyshop	S K AY SH AA P
o	OW
sudarshan	S UW D AA R SH AH N
allergenics	AO L ER JH IY N IH K S
blackseed	B L AE K S IY D
wall	W AO L
than	DH AE N
than(2)	DH AH N
office	AO F AH S
band	B AE N D
city	S IH T IY
solved	S AA L V D
astrology	AH S T R AA L AH JH IY
pack	P AE K
mill	M IH L
venkateswara	V EH NG K AH T EH S W AH R AH
before	B IH F AO R
before(2)	B IY F AO R
breakdown	B R EY K D AW N
indira	IH N D IH R AH
wisdom	W IH Z D AH M
mango	M AE NG G OW
micromanagement	M AY K R OW M AE N IH JH M AH N T
cow	K AW
mechanics	M AH K AE N IH K S
did	D IH D
presidential	P R EH Z AH D EH N SH AH L
bubblegum	B AH B AH L G AH M
sony	S OW N IY
wardrobe	W AO R D R OW B
seeing	S IY IH NG
incredible	IH N K R EH D AH B AH L
kamlesh	K AE M L AH SH
gagandeep	G AE G AH N D IY P
from	F R AH M
techniques	T EH K N IY K S
faster	F AE S T ER
train	T R EY N
lamps	L AE M P S
bhopal	B OW P AA L
finder	F AY N D ER
boutique	B UW T IY K
singhal	S IH N AH L
the	DH AH
the(2)	DH IY
combo	K AA M B OW
robot	R OW B AA T
robot(2)	R OW B AH T
collection	K AH L EH K SH AH N
prescription	P R AH S K R IH P SH AH N
phones	F OW N Z
owning	OW N IH NG
short	SH AO R T
now	N AW
thorium	TH AA R IY AH M
yellow	Y EH L OW
marshal	M AA R SH AH L
shirt	SH ER T
entrance	EH N T R AH N S
oils	OY L Z
killed	K IH L D
deliverance	D IH L IH V ER AH N S
deliverance(2)	D IH L IH V R AH N S
scripts	S K R IH P T S
scripts(2)	S K R IH P S
used	Y UW Z D
embroidered	EH M B R OY D ER D
responsible	R IY S P AA N S AH B AH L
victor	V IH K T ER
storage	S T AO R AH JH
storage(2)	S T AO R IH JH
story	S T AO R IY
wear	W EH R
monitors	M AA N AH T ER Z
writer	R AY T ER
dazzling	D AE Z AH L IH NG
dazzling(2)	D AE Z L IH NG
blueberry	B L UW B EH R IY
matadi	M AE T AH D IY
astrologer	AH S T R AA L AH JH ER
super	S UW P ER
womens	W IH M AH N Z
womens(2)	W UW M AH N Z
srinidhi	S R AH N IH D HH IY
fertilizing	F ER T AH L AY Z IH NG
store	S T AO R
herringshaw	HH EH R IH NG SH AO
force	F AO R S
parts	P AA R T S
sunshine	S AH N SH AY N
spirit	S P IH R AH T
spirit(2)	S P IH R IH T
englishman	IH NG G L IH SH M AH N
madhya	M AE D HH AY AH
thanked	TH AE NG K T
shoppee	SH AA P IY
disenfranchisement	D IH S IH N F R AE N CH AY Z M AH N T
examination	IH G Z AE M AH N EY SH AH N
fragrances	F R EY G R AH N S AH Z
fragrances(2)	F R EY G R AH N S IH Z
academy	AH K AE D AH M IY
texts	T EH K S T S
how	HH AW
might	M AY T
should	SH UH D
shark	SH AA R K
hot	HH AA T
misrepresentations	M IH S R EH P R IH Z EH N T EY SH AH N Z
lean	L IY N
decoratives	D EH K AH R EY T IH V Z
knowledge	N AA L AH JH
knowledge(2)	N AA L IH JH
gym	JH IH M
pushbrite	P AH SH B R AY T
limits	L IH M AH T S
limits(2)	L IH M IH T S
golden	G OW L D AH N
disproportionately	D IH S P R AH P AO R SH AH N AH T L IY
continental	K AA N T AH N EH N T AH L
continental(2)	K AA N T AH N EH N AH L
pretty	P R IH T IY
reauthorization	R IY AO TH ER IH Z EY SH AH N
anti	AE N T IY
anti(2)	AE N T AY
want	W AA N T
want(2)	W AO N T
changing	CH EY N JH IH NG
beant	B IH AE N T
दल	D AH L
पैकिंग	P AE K IH N G
कार्यवाही	K AA R Y AH W AA HH IY
कार्य	K AA R Y
पैट्रॉल	P AE T R AO L
अत्तर	AH T T AH R
स्मार्टफ़ोन	S M AA R T AH F OW N
सप्लाई	S AH P L AA IY
ब्यावर	B Y AA W AH R
वॉच	W AO CH
सुनाना	S UH N AA N AA
आने	AA N EY
चम्पक	CH AH M P AH K
क्लास्मेट	K L AA S M EY T
जामुन	JH AA M UH N
दिखाता	D IH K HH AA T AA
अपर	AH P AH R
लैवेंडर	L AE W EY N D AH R
गढ्ढे	G AH DH DH EY
कर	K AH R
आत्मा	AA T M AA
बालों	B AA L OW N
पॉलिश	P AO L IH SH
कॉबालट	K AO B AA L AH T
पड़ा	P AH D AA
अकोला	AH K OW L AA
हील्स	HH IY L S
एप्सन	EY P S AH N
संहिता	S AH N HH IH T AA
डिस्कोथेक	D IH S K OW TH EY K
खुराफात	K HH UH R AA F AA T
प्रीपेड	P R IY P EY D
दूसरा	D UW S AH R AA
खड़े	K HH AH D EY
सीरीज़	S IY R IY JH
बनाने	B AH N AA N EY
देश	D EY SH
फेरारी	F EY R AA R IY
उसका	UH S AH K AA
पंचनामे	P AH N CH AH N AA M EY
सकेगा	S AH K EY G AA
जुर्राब	JH UH R R AA B
होते	HH OW T EY
तस्वीरें	T AH S W IY R EY N
ख़ास	K HH AA S
लस्सी	L AH S S IY
जगदेव	JH AH G AH D EY W
कंप्यूटर	K AH M P Y UW T AH R
शाईन	SH AA IY N
नूडल्स	N UW D AH L S
बलराज	B AH L AH R AA JH
शेरवानी	SH EY R AH W AA N IY
प्याज	P Y AA JH
पर	P AH R
लखानी	L AH K HH AA N IY
रियायतें	R IH Y AA Y AH T EY N
एविएटर	EY W IH EY T AH R
देखिए	D EY K HH IH EY
रिमोट	R IH M OW T
हाथ	HH AA TH
मशिन	M AH SH IH N
रहने	R AH HH AH N EY
स्पिकर	S P IH K AH R
अगस्त	AH G AH S T
आभूषण	AA B HH UW SH AH N
जर्किन	JH AH R K IH N
राजस्थानी	R AA JH AH S TH AA N IY
डाई	D AA IY
शाइन	SH AA IH N
केशवलाल	K EY SH AH W AH L AA L
क्रीम्स	K R IY M S
राठौड़	R AA TH AO D
बैट	B AE T
अच्छी	AH CH CH IY
बोलते	B OW L AH T EY
पूना	P UW N AA
जाय	JH AA Y
गुरुवार	G UH R UH W AA R
बावन	B AA W AH N
क्षतिग्रस्त	K SH AH T IH G R AH S T
गार्ड	G AA R D
पाठ्यपुस्तकों	P AA TH Y AH P UH S T AH K OW N
टाइमैक्स	T AA IH M AE K S
मॉडेम	M AO D EY M
कार्यरत	K AA R Y AH R AH T
जापान	JH AA P AA N
ग्लव्स	G L AH W S
वोडाफोन	W OW D AA F OW N
मध्यावधि	M AH DH Y AA W AH DH IH
भागवत	B HH AA G AH W AH T
डिस्क्स	D IH S K S
दिलचस्पी	D IH L AH CH AH S P IY
मुझे	M UH ZH EY
भारती	B HH AA R AH T IY
कलर्स	K AH L AH R S
एडिडास	EY D IH D AA S
परफ्यूम	P AH R AH F Y UW M
बिताते	B IH T AA T EY
यहीं	Y AH HH IY N
जरा	JH AH R AA
वुल्स्टन	W UH L S T AH N
आयुक्त	AA Y UH K T
काली	K AA L IY
आपका	AA P AH K AA
लड़कियों	L AH D K IH Y OW N
कठैला	K AH TH AE L AA
हूं	HH UW N
ब्लड	B L AH D
पनीर	P AH N IY R
काला	K AA L AA
जितना	JH IH T AH N AA
कपड़े	K AH P AH D EY
फ़्लैश	F L AE SH
धमकी	DH AH M AH K IY
संदेह	S AH N D EY HH
बर्फी	B AH R F IY
गर्ल्ज	G AH R L JH
काका	K AA K AA
दुखी	D UH K HH IY
सिर्फ	S IH R F
नाग	N AA G
आर	AA R
बनाकर	B AH N AA K AH R
व्हीलर	W HH IY L AH R
प्रैक्टिस	P R AE K T IH S
राउरकेला	R AA UH R AH K EY L AA
कर्ज़दार	K AH R JH D AA R
सम्मोहन	S AH M M OW HH AH N
गॉगल्स	G AO G AH L S
मैगापिक्सल	M AE G AA P IH K S AH L
अपराधियों	AH P AH R AA DH IH Y OW N
स्टील	S T IY L
ऐंड	AE N D
कानून	K AA N UW N
बक्सा	B AH K S AA
आंदोलन	AA N D OW L AH N
टैंट	T AE N T
बेबी	B EY B IY
डबल	D AH B AH L
गुत्ता	G UH T T AA
बेक	B EY K
जून	JH UW N
देखकर	D EY K HH AH K AH R
दही	D AH HH IY
डिब्बी	D IH B B IY
खुल	K HH UH L
थर्मामीटर	TH AH R M AA M IY T AH R
पोंछा	P OW N CH AA
चैलेंजर	CH AE L EY N JH AH R
ट्यूबलाइट	T Y UW B AH L AA IH T
संर्वधन	S AH N R W AH DH AH N
अकादमी	AH K AA D AH M IY
कपड़ा	K AH P AH D AA
मिलैनियम	M IH L AE N IH Y AH M
कादम्बरी	K AA D AH M B AH R IY
टूरिस्ट	T UW R IH S T
खाकी	K HH AA K IY
काश्तकारी	K AA SH T AH K AA R IY
आवश्यकता	AA W AH SH Y AH K AH T AA
शार्पनर	SH AA R P AH N AH R
उठाये	UH TH AA Y EY
रूट	R UW T
स्वतन्त्रता	S W AH T AH N T R AH T AA
मैटरेस	M AE T AH R EY S
बोली	B OW L IY
बल्ब	B AH L B
मोटो	M OW T OW
मिक्सर	M IH K S AH R
समझते	S AH M AH ZH AH T EY
सूट	S UW T
एथ्निक	EY TH N IH K
अल्फ़ा	AH L F AA
मजबूर	M AH JH AH B UW R
ईख	IY K HH
जुगनू	JH UH G AH N UW
आरओ	AA R OW
भेजते	B HH EY JH AH T EY
पाँव	P AA N W
अवसर	AH W AH S AH R
वुमेन्स	W UH M EY N S
फेशिअल	F EY SH IH AH L
रिवाजों	R IH W AA JH OW N
रिपीलेंट	R IH P IY L EY N T
डालने	D AA L AH N EY
श्मशान	SH M AH SH AA N
स्पाइस	S P AA IH S
पाऊच	P AA UW CH
स्लीपवैल	S L IY P AH W AE L
कनेक्शन	K AH N EY K SH AH N
नाईलॉन	N AA IY L AO N
बॉय	B AO Y
संस्कार	S AH N S K AA R
आकर्षक	AA K AH R SH AH K
जितने	JH IH T AH N EY
यूनिफॉर्म	Y UW N IH F AO R M
घरेलू	G HH AH R EY L UW
यहाँ	Y AH HH AA N
मइया	M IH Y AA
चंदानी	CH AH N D AA N IY
मेरी	M EY R IY
हील	HH IY L
सेलर्स	S EY L AH R S
मेवा	M EY W AA
ह्युन्डाई	HH Y UH N D AA IY
सम्पुर्ण	S AH M P UH R N
सबकी	S AH B AH K IY
रामदास	R AA M AH D AA S
धवन	DH AH W AH N
महंगी	M AH HH AH N G IY
मिली	M IH L IY
डेकोरेटर	D EY K OW R EY T AH R
अठहत्तर	AH TH AH HH AH T T AH R
पिंपल	P IH M P AH L
पिचकारी	P IH CH AH K AA R IY
चूहेदानी	CH UW HH EY D AA N IY
व्यक्ति	W Y AH K T IH
नाई	N AA IY
बॉटल	B AO T AH L
गोदाम	G OW D AA M
डालता	D AA L AH T AA
आउट्डोर	AA UH T D OW R
पॉकेट	P AO K EY T
रॉयल	R AO Y AH L
गाथा	G AA TH AA
बोध	B OW DH
जी	JH IY
रेड	R EY D
हॉफ	HH AO F
इजाजत	IH JH AA JH AH T
जोधा	JH OW DH AA
टॉवल	T AO W AH L
अमूल	AH M UW L
वर्ना	W AH R N AA
विडिओकॉन	W IH D IH OW K AO N
वे	W EY
विषय	W IH SH AH Y
मई	M IY
मिल्क	M IH L K
अगर	AH G AH R
जूती	JH UW T IY
डिटेक्टर	D IH T EY K T AH R
अवहेलना	AH W AH HH EY L AH N AA
देवी	D EY W IY
सैंडल्स	S AE N D AH L S
गिरफ्त	G IH R AH F T
स्प्लिट	S P L IH T
कहिये	K AH HH IH Y EY
धनिया	DH AH N IH Y AA
माइक्रोसॉफ्ट	M AA IH K R OW S AO F T
युग	Y UH G
रेशम	R EY SH AH M
बदहवास	B AH D AH HH AH W AA S
बूस्टर	B UW S T AH R
मुनि	M UH N IH
सफ़र	S AH F R
बाज़ार	B AA JH AA R
सिंथेटिक	S IH N TH EY T IH K
गीगाबाइट	G IY G AA B AA IH T
आपत्ति	AA P AH T T IH
इन्वर्टर	IH N W AH R T AH R
रचना	R AH CH AH N AA
सागर	S AA G AH R
अक्सर	AH K S AH R
अंदमान	AH N D AH M AA N
खिलता	K HH IH L AH T AA
साहित्य	S AA HH IH T Y
पिन	P IH N
फैसला	F AE S AH L AA
अग्रवाल	AH G R AH W AA L
कोल्हापुरी	K OW L HH AA P UH R IY
वर्क	W AH R K
अध्याय	AH DH Y AA Y
मारूति	M AA R UW T IH
मेकर	M EY K AH R
मशक्कत	M AH SH AH K K AH T
केन	K EY N
प्रोटेक्टेड	P R OW T EY K T EY D
रेडमी	R EY D AH M IY
पैर	P AE R
फाड़	F AA D
दीजिए	D IY JH IH EY
वेहिकल्स	W EY HH IH K AH L S
शब्द	SH AH B D
पेठा	P EY TH AA
ओटीजी	OW T IY JH IY
जीपीएस	JH IY P IY EY S
रामनाथ	R AA M AH N AA TH
थाम	TH AA M
देंगे	D EY N G EY
इकट्ठा	IH K AH T TH AA
चोली	CH OW L IY
ओरिजिनल	OW R IH JH IH N AH L
स्टिकर्स	S T IH K AH R S
पोषण	P OW SH AH N
ग्लास	G L AA S
शिफान	SH IH F AA N
बाजार	B AA JH AA R
विभा	W IH B HH AA
वाटरप्रूफ	W AA T AH R AH P R UW F
वाचनालय	W AA CH AH N AA L AH Y
लिखा	L IH K HH AA
मीनू	M IY N UW
कृष्णा	K R IH SH N AA
बेरूत	B EY R UW T
मिल	M IH L
पाकेट	P AA K EY T
नए	N EY
जुलाहों	JH UH L AA HH OW N
हमें	HH AH M EY N
सेना	S EY N AA
समझा	S AH M AH ZH AA
प्रसन्न	P R AH S AH N N
यूनो	Y UW N OW
मुँह	M UH N HH
मंशा	M AH N SH AA
आकर	AA K AH R
स्केल	S K EY L
स्क्रब	S K R AH B
बाँह	B AA N HH
प्रश्नपत्र	P R AH SH N AH P AH T R
पेंटिंग	P EY N T IH N G
इटालियन	IH T AA L IH Y AH N
लाइट	L AA IH T
अनुवाद	AH N UH W AA D
उर्जा	UH R JH AA
मछरदानी	M AH CH AH R AH D AA N IY
यूनिवर्सिटी	Y UW N IH W AH R S IH T IY
मोटापा	M OW T AA P AA
मोज़े	M OW JH EY
उनकी	UH N AH K IY
हमेशा	HH AH M EY SH AA
मिक्स	M IH K S
वुमेन	W UH M EY N
नसैनी	N AH S AE N IY
ड्रेसेज	D R EY S EY JH
परेशान	P AH R EY SH AA N
फ्रूट	F R UW T
गिटार	G IH T AA R
शुद्ध	SH UH D DH
सोलुस	S OW L UH S
रवैया	R AH W AE Y AA
सुनाता	S UH N AA T AA
इन्टैक्स	IH N T AE K S
बोनिला	B OW N IH L AA
ज़यादा	JH Y AA D AA
हिन्दू	HH IH N D UW
चैंपियन	CH AE M P IH Y AH N
डाली	D AA L IY
चावला	CH AA W AH L AA
डेरी	D EY R IY
सुई	S UH IY
गुस्सा	G UH S S AA
दर्पण	D AH R P AH N
मोहम्मद	M OW HH AH M M AH D
लैदर	L AE D AH R
सम्बंधित	S AH M B AH N DH IH T
जोहरा	JH OW HH AH R AA
बोलेरो	B OW L EY R OW
जोरदार	JH OW R AH D AA R
ऑल	AO L
ब्रांडेड	B R AA N D EY D
नोटपैड	N OW T AH P AE D
राघो	R AA G HH OW
सुधा	S UH DH AA
पेय	P EY Y
बार	B AA R
कोलोरैडो	K OW L OW R AE D OW
डेनीम	D EY N IY M
झांई	ZH AA N IY
टैलीग्राफ	T AE L IY G R AA F
सहिष्णुता	S AH HH IH SH N UH T AA
स्पाइसेज	S P AA IH S EY JH
जॉर्जेट	JH AO R JH EY T
पुस्तकें	P UH S T AH K EY N
मिस	M IH S
कर्लोन	K AH R L OW N
सोने	S OW N EY
बुक्स	B UH K S
हालांकि	HH AA L AA N K IH
इयरफोन्स	IH Y AH R AH F OW N S
म्यूजिक	M Y UW JH IH K
मालिक	M AA L IH K
विवाह	W IH W AA HH
फस्ट	F AH S T
इंजन	IH N JH AH N
दोस्ती	D OW S T IY
पूजा	P UW JH AA
उदाहरण	UH D AA HH AH R AH N
का	K AA
कहें	K AH HH EY N
बनी	B AH N IY
बनाई	B AH N AA IY
आइये	AA IH Y EY
जिलेट	JH IH L EY T
आकाशी	AA K AA SH IY
बाहर	B AA HH AH R
मैन	M AE N
प्रेसीडेंट	P R EY S IY D EY N T
मान	M AA N
अमिश	AH M IH SH
चीता	CH IY T AA
साइज़	S AA IH JH
हरी	HH AH R IY
बेनेटन	B EY N EY T AH N
शेपर	SH EY P AH R
भाव	B HH AA W
ढंग	DH AH N G
लगाने	L AH G AA N EY
अनुभव	AH N UH B HH AH W
होर्न	HH OW R N
काठियावाड़ी	K AA TH IH Y AA W AA D IY
देकर	D EY K AH R
यूज़	Y UW JH
लौटो	L AO T OW
इम्प्रूवमेंट	IH M P R UW W AH M EY N T
वहीं	W AH HH IY N
डॉक्टर	D AO K T AH R
लगाई	L AH G AA IY
बुट	B UH T
चिवड़ा	CH IH W AH D AA
निःशब्द	N IH SH AH B D
ऑस्ट्रेलिया	AO S T R EY L IH Y AA
प्रो	P R OW
सीखना	S IY K HH AH N AA
बिहारी	B IH HH AA R IY
फायदा	F AA Y AH D AA
पूर्ति	P UW R T IH
दृढ़ता	D R IH DH T AA
पर्यवेक्षक	P AH R Y AH W EY K SH AH K
जाकर	JH AA K AH R
लोगे	L OW G EY
गई	G IY
बोलती	B OW L AH T IY
बता	B AH T AA
औरत	AO R AH T
मीमांसा	M IY M AA N S AA
चीजें	CH IY JH EY N
जमीनें	JH AH M IY N EY N
बनाती	B AH N AA T IY
भरा	B HH AH R AA
इन्फोकस	IH N F OW K AH S
अमरावती	AH M AH R AA W AH T IY
जकैट	JH AH K AE T
देगी	D EY G IY
ट्रेवल	T R EY W AH L
चीफ	CH IY F
टब	T AH B
फ्लिप	F L IH P
दूसरे	D UW S AH R EY
चेयर	CH EY Y AH R
टाटा	T AA T AA
हँडबॅग	HH AH N D AH B G
वर्धक	W AH R DH AH K
दरअसल	D AH R AH S AH L
भारतीय	B HH AA R AH T IY Y
साबुन	S AA B UH N
बदमाशी	B AH D AH M AA SH IY
पिक्चरें	P IH K CH AH R EY N
पाकिस्तान	P AA K IH S T AA N
नोट	N OW T
रक्त	R AH K T
पकड़	P AH K AH D
लड़कों	L AH D K OW N
जल्द	JH AH L D
तहकीकात	T AH HH AH K IY K AA T
जॉगिंग	JH AO G IH N G
चीज	CH IY JH
वक़्त	W AH K T
ऐक्सक्ल्यूज़िव	AE K S AH K L Y UW JH IH W
स्टेप	S T EY P
लेखिका	L EY K HH IH K AA
उत्कर्ष	UH T K AH R SH
एफ़	EY F
मानना	M AA N AH N AA
सबसे	S AH B AH S EY
अम्बरीश	AH M B AH R IY SH
पच्चीस	P AH CH CH IY S
फैशन	F AE SH AH N
नया	N AH Y AA
ग्रामपंचायत	G R AA M AH P AH N CH AA Y AH T
आर्ट्स	AA R T S
फॉर	F AO R
जन	JH AH N
माइक्रोमेक्स	M AA IH K R OW M EY K S
साथ	S AA TH
पद्धति	P AH D DH AH T IH
रैडी	R AE D IY
मेहनती	M EY HH AH N AH T IY
बुरका	B UH R AH K AA
महल	M AH HH AH L
रोज़मैरी	R OW JH M AE R IY
हुक्का	HH UH K K AA
हिताची	HH IH T AA CH IY
कोर्स	K OW R S
टोपी	T OW P IY
आपकी	AA P AH K IY
स्टैंड	S T AE N D
इक	IH K
प्रॉमिज़	P R AO M IH JH
ऑप्टिमा	AO P T IH M AA
मनाचे	M AH N AA CH EY
वुलेन	W UH L EY N
प्रसिद्ध	P R AH S IH D DH
आवश्यकताओं	AA W AH SH Y AH K AH T AA OW N
नेबुलाईजर	N EY B UH L AA IY JH AH R
सौ	S AO
पैसे	P AE S EY
स्थान	S TH AA N
शोक	SH OW K
मुस्कुराकर	M UH S K UH R AA K AH R
माल	M AA L
पड़ोस	P AH D OW S
फैब्रुअरी	F AE B R UH AH R IY
मसाले	M AH S AA L EY
लायी	L AA Y IY
अमर	AH M AH R
किचन	K IH CH AH N
छोड़कर	CH OW D K AH R
कीपैड	K IY P AE D
फोर	F OW R
हाफ	HH AA F
सारीज़	S AA R IY JH
करोड़पति	K AH R OW D P AH T IH
बिडींग	B IH D IY N G
शुटिंग	SH UH T IH N G
प्रक्रियाओं	P R AH K R IH Y AA OW N
शक्ति	SH AH K T IH
अधिकतर	AH DH IH K AH T AH R
बाबा	B AA B AA
जल	JH AH L
तुलसी	T UH L AH S IY
पैदावार	P AE D AA W AA R
ऑर्गन	AO R G AH N
प्यूमा	P Y UW M AA
जैनुअरी	JH AE N UH AH R IY
भौतिकवादी	B HH AO T IH K AH W AA D IY
साफ़	S AA F
इण्टरमीडिएट	IH N T AH R AH M IY D IH EY T
हाव	HH AA W
बकवास	B AH K AH W AA S
नाश्ता	N AA SH T AA
गुजराती	G UH JH AH R AA T IY
धमकाया	DH AH M AH K AA Y AA
घास	G HH AA S
जैसे	JH AE S EY
निर्वाचन	N IH R W AA CH AH N
कर्तव्यों	K AH R T AH W Y OW N
प्रभाव	P R AH B HH AA W
सीढ़ी	S IY DH IY
तापक	T AA P AH K
तरीके	T AH R IY K EY
दीवाना	D IY W AA N AA
बांधें	B AA N DH EY N
हेलीकाप्टर	HH EY L IY K AA P T AH R
वोल्टास	W OW L T AA S
त्रिवेदी	T R IH W EY D IY
ग्लूकोस	G L UW K OW S
साड़ीस	S AA D IY S
फिफ्टी	F IH F T IY
फाइबर	F AA IH B AH R
पदक	P AH D AH K
बैंक्स	B AE N K S
मिल्टन	M IH L T AH N
ऑफ	AO F
फोल्डिंग	F OW L D IH N G
औज़ार	AO JH AA R
देगा	D EY G AA
ग्रेजुएट	G R EY JH UH EY T
अंगूठी	AH N G UW TH IY
ग्रैंड	G R AE N D
च्यवनप्राश	CH Y AH W AH N AH P R AA SH
टेल	T EY L
थप्पड़	TH AH P P AH D
डब्बा	D AH B B AA
फ्लैट	F L AE T
मंगलवार	M AH N G AH L AH W AA R
स्वर	S W AH R
जिनका	JH IH N AH K AA
सारीज	S AA R IY JH
सूझेगा	S UW ZH EY G AA
आदमी	AA D AH M IY
अनाज	AH N AA JH
युरेका	Y UH R EY K AA
जिंदगी	JH IH N D AH G IY
रोकटोक	R OW K AH T OW K
रूप	R UW P
लिक्विड	L IH K W IH D
प्रमुख	P R AH M UH K HH
सबमर्सिबल	S AH B AH M AH R S IH B AH L
भावना	B HH AA W AH N AA
सपना	S AH P AH N AA
धांय	DH AA N Y
पुतला	P UH T AH L AA
पावर	P AA W AH R
एक्सेसरीज	EY K S EY S AH R IY JH
उन्यासी	UH N Y AA S IY
गाड़	G AA D
एनालौग	EY N AA L AO G
दौड़	D AO D
जाकेट	JH AA K EY T
कॉम	K AO M
सफ़ारी	S AH F AA R IY
एकता	EY K AH T AA
पाठमाला	P AA TH AH M AA L AA
जटायु	JH AH T AA Y UH
पॉल	P AO L
ऑडियो	AO D IH Y OW
विशेषज्ञ	W IH SH EY SH AH G Y
मे	M EY
झेप	ZH EY P
प्रोत्साहित	P R OW T S AA HH IH T
जगहों	JH AH G AH HH OW N
कोलगेट	K OW L AH G EY T
श्रमिकों	SH R AH M IH K OW N
करूंगा	K AH R UW N G AA
रिद्धि	R IH D DH IH
चूड़ियाँ	CH UW D IH Y AA N
नगाड़े	N AH G AA D EY
बहादुरी	B AH HH AA D UH R IY
जींस	JH IY N S
ईनर	IY N AH R
करें	K AH R EY N
इडली	IH D AH L IY
योग	Y OW G
ड्राई	D R AA IY
धर्मवीर	DH AH R M AH W IY R
हॉर्लिक्स	HH AO R L IH K S
करते	K AH R AH T EY
रक्षा	R AH K SH AA
नये	N AH Y EY
राजनीतिक	R AA JH AH N IY T IH K
तैरता	T AE R AH T AA
डिस्क	D IH S K
उन्हीं	UH N HH IY N
ठिकाने	TH IH K AA N EY
अपने	AH P AH N EY
हैडसैट	HH AE D AH S AE T
जवाब	JH AH W AA B
सब	S AH B
पंचारिष्ट	P AH N CH AA R IH SH T
ब्लैक	B L AE K
लक्स	L AH K S
मुश्किलों	M UH SH K IH L OW N
विकलांगो	W IH K AH L AA N G OW
सुगन्धित	S UH G AH N DH IH T
करने	K AH R AH N EY
चार	CH AA R
वॉशिंग	W AO SH IH N G
सोना	S OW N AA
कार्तिकेय	K AA R T IH K EY Y
क्योंकि	K Y OW N K IH
फर्नीचर	F AH R N IY CH AH R
वुडरफ	W UH D AH R AH F
पैन	P AE N
बिलकुल	B IH L AH K UH L
पैड	P AE D
सेक्शन	S EY K SH AH N
तौर	T AO R
एक्स्टेंडेड	EY K S T EY N D EY D
सनग्लासेस	S AH N AH G L AA S EY S
श्रीनाथ	SH R IY N AA TH
फ्रायर	F R AA Y AH R
भाग्यशाली	B HH AA G Y AH SH AA L IY
संरचना	S AH N R AH CH AH N AA
भीड़	B HH IY D
उपकरण	UH P AH K AH R AH N
नही	N AH HH IY
थिऐटर	TH IH AE T AH R
तबलची	T AH B AH L AH CH IY
साडी	S AA D IY
सिवा	S IH W AA
धमाका	DH AH M AA K AA
डब्बे	D AH B B EY
अशोक	AH SH OW K
नेस्कैफे	N EY S K AE F EY
अरनॉल्ड	AH R AH N AO L D
विवेकानंद	W IH W EY K AA N AH N D
गर्मी	G AH R M IY
गुलाब	G UH L AA B
पशुओं	P AH SH UH OW N
मृत्युंजय	M R IH T Y UH N JH AH Y
अपनी	AH P AH N IY
चंद	CH AH N D
गाएँ	G AA EY N
ऑयल	AO Y AH L
बचते	B AH CH AH T EY
इतना	IH T AH N AA
मोबाईल	M OW B AA IY L
वैज्ञानिक	W AE G Y AA N IH K
लूं	L UW N
जंबो	JH AH M B OW
बाल	B AA L
ज़ीलैंड	JH IY L AE N D
उठा	UH TH AA
ड्राईवर	D R AA IY W AH R
सेट्स	S EY T S
साज़	S AA JH
तरफ	T AH R AH F
पश्चिमी	P AH SH CH IH M IY
फलालैन	F AH L AA L AE N
डोमिनोज़	D OW M IH N OW JH
बताना	B AH T AA N AA
फ़िल्मों	F IH L M OW N
थोड़ा	TH OW D AA
भविष्य	B HH AH W IH SH Y
विडम्बना	W IH D AH M B AH N AA
दवाईयां	D AH W AA IY Y AA N
आचार्य	AA CH AA R Y
टीवी	T IY W IY
आक्रमण	AA K R AH M AH N
कम्पनी	K AH M P AH N IY
छाते	CH AA T EY
मामलों	M AA M AH L OW N
आईएएस	AA IY EY EY S
किट	K IH T
कर्टन	K AH R T AH N
बेंगलुरु	B EY N G AH L UH R UH
जूलॉजी	JH UW L AO JH IY
इंजिनियरिंग	IH N JH IH N IH Y AH R IH N G
डोलची	D OW L AH CH IY
पूछते	P UW CH AH T EY
कैल्कुलेटर	K AE L K UH L EY T AH R
वैक्युम	W AE K Y UH M
पति	P AH T IH
मट्ठा	M AH T TH AA
स्टेशन	S T EY SH AH N
गोस्वामी	G OW S W AA M IY
आजकल	AA JH AH K AH L
केयर	K EY Y AH R
पेंसिल	P EY N S IH L
वीवो	W IY W OW
जीबी	JH IY B IY
वायरलैस	W AA Y AH R AH L AE S
चैरी	CH AE R IY
हैन्डिक्राफ्ट्स	HH AE N D IH K R AA F T S
अश्वगंधा	AH SH W AH G AH N DH AA
वाद्य	W AA D Y
आदि	AA D IH
एप्रिल	EY P R IH L
जॉन	JH AO N
जाता	JH AA T AA
ताज़	T AA JH
पेड़	P EY D
स्लीपवियर	S L IY P AH W IH Y AH R
बैडिंग	B AE D IH N G
शैली	SH AE L IY
जिवानी	JH IH W AA N IY
शैम्पू	SH AE M P UW
बिरंगी	B IH R AH N G IY
तनाव	T AH N AA W
पहचाना	P AH HH AH CH AA N AA
धंधा	DH AH N DH AA
वर्मा	W AH R M AA
यन्त्र	Y AH N T R
पॉइंट	P AO IH N T
शर्ट	SH AH R T
बम	B AH M
फ्लीट	F L IY T
एकांकिका	EY K AA N K IH K AA
नीला	N IY L AA
शास्त्र	SH AA S T R
कलाई	K AH L AA IY
बॉलीवुड	B AO L IY W UH D
अरस्तु	AH R AH S T UH
चाँद	CH AA N D
माइक्रो	M AA IH K R OW
हाथी	HH AA TH IY
शेरो	SH EY R OW
हीरे	HH IY R EY
मापक	M AA P AH K
ग़ज़ल	G JH L
दे	D EY
बैटरी	B AE T AH R IY
गुजारी	G UH JH AA R IY
मेन	M EY N
सैमसंग	S AE M AH S AH N G
अनजान	AH N AH JH AA N
मथुरा	M AH TH UH R AA
सबेरे	S AH B EY R EY
देसाई	D EY S AA IY
पिस्ता	P IH S T AA
फोन	F OW N
ब्रशेज	B R AH SH EY JH
इंटेक्स	IH N T EY K S
लक्ष्मीपति	L AH K SH M IY P AH T IH
वंडरशैफ	W AH N D AH R AH SH AE F
आकाश	AA K AA SH
छीलने	CH IY L AH N EY
प्रयोगों	P R AH Y OW G OW N
मेहँदी	M EY HH AH N D IY
फॉलो	F AO L OW
आपसे	AA P AH S EY
ऊपरी	UW P AH R IY
खिलोने	K HH IH L OW N EY
इनो	IH N OW
लाभ	L AA B HH
तकनीकी	T AH K AH N IY K IY
अंतिम	AH N T IH M
आज्ञा	AA G Y AA
टीवीज़	T IY W IY JH
कल	K AH L
ट्वीटर	T W IY T AH R
पर्फ्यूम्स	P AH R F Y UW M S
खोदकर	K HH OW D AH K AH R
बाय	B AA Y
गढ़मुक्खा	G AH DH M UH K K HH AA
लाभान्वित	L AA B HH AA N W IH T
सलून	S AH L UW N
कमज़ोर	K AH M AH JH OW R
लाभप्रद	L AA B HH AH P R AH D
कीजिये	K IY JH IH Y EY
खैर	K HH AE R
लाइफबॉय	L AA IH F AH B AO Y
सीएफएल	S IY EY F EY L
फूट	F UW T
बैल	B AE L
एंटरप्राइजेज	EY N T AH R AH P R AA IH JH EY JH
फासट्रैक	F AA S AH T R AE K
चकमा	CH AH K AH M AA
बच	B AH CH
वृद्धावस्था	W R IH D DH AA W AH S TH AA
होकर	HH OW K AH R
हाकिन्स	HH AA K IH N S
अभी	AH B HH IY
पंजाबी	P AH N JH AA B IY
औषधि	AO SH AH DH IH
बैग्स	B AE G S
सीज़	S IY JH
आग	AA G
इन	IH N
ट्रैक्टर	T R AE K T AH R
लिनेावो	L IH N EY AA W OW
रह	R AH HH
वेलवेट	W EY L AH W EY T
एरा	EY R AA
अधूरे	AH DH UW R EY
डुअल	D UH AH L
जन्तु	JH AH N T UH
भले	B HH AH L EY
फार्मूला	F AA R M UW L AA
छुपाने	CH UH P AA N EY
नीरो	N IY R OW
शुरू	SH UH R UW
सुर्यकात	S UH R Y AH K AA T
कारण	K AA R AH N
वूफर	W UW F AH R
जिम	JH IH M
सुपर	S UH P AH R
हॉल	HH AO L
ब्याह	B Y AA HH
भिन्डी	B HH IH N D IY
ज़ेरॉक्स	JH EY R AO K S
इस	IH S
जोत	JH OW T
प्योर	P Y OW R
मुक्तेश्वर	M UH K T EY SH W AH R
चौंतीस	CH AO N T IY S
वेक्टर	W EY K T AH R
दावों	D AA W OW N
आनंदित	AA N AH N D IH T
तैयार	T AE Y AA R
बैंगल्स	B AE N G AH L S
मेमौरी	M EY M AO R IY
भेजी	B HH EY JH IY
परिचित	P AH R IH CH IH T
कीजिए	K IY JH IH EY
ज़न्नत	JH N N AH T
निराधार	N IH R AA DH AA R
हैं	HH AE N
प्रूफ	P R UW F
मानकर	M AA N AH K AH R
जायेगा	JH AA Y EY G AA
हेड्फोन	HH EY D F OW N
कतरनें	K AH T AH R AH N EY N
प्लॉट्स	P L AO T S
सॉक्स	S AO K S
ऐसी	AE S IY
लौरियल	L AO R IH Y AH L
सुजोक	S UH JH OW K
यूरेका	Y UW R EY K AA
प्रबोधक	P R AH B OW DH AH K
एनसीआरटी	EY N AH S IY AA R AH T IY
लौट	L AO T
खुशाली	K HH UH SH AA L IY
अटेचिंग	AH T EY CH IH N G
लुंगी	L UH N G IY
हरदम	HH AH R AH D AH M
स्टड्स	S T AH D S
मेरे	M EY R EY
बदले	B AH D AH L EY
विद्या	W IH D Y AA
इन्डियन	IH N D IH Y AH N
सर्विसेज़	S AH R W IH S EY JH
आते	AA T EY
यूथ	Y UW TH
सुनाया	S UH N AA Y AA
साइकिल	S AA IH K IH L
टोटल	T OW T AH L
ऐच्छिक	AE CH CH IH K
खेल	K HH EY L
सत्य	S AH T Y
वाटर	W AA T AH R
निओ	N IH OW
ब्लूटुथ	B L UW T UH TH
लंच	L AH N CH
अफ़सोस	AH F S OW S
अरब	AH R AH B
वक्ता	W AH K T AA
बहत्तर	B AH HH AH T T AH R
लगता	L AH G AH T AA
लिख	L IH K HH
राष्ट्रीय	R AA SH T R IY Y
कागज	K AA G AH JH
शेम्पू	SH EY M P UW
सहज	S AH HH AH JH
मेलूहा	M EY L UW HH AA
प्रूफ़	P R UW F
हमारा	HH AH M AA R AA
धीरे	DH IY R EY
धर्मेश	DH AH R M EY SH
इन्सान	IH N S AA N
जंबू	JH AH M B UW
ऐरो	AE R OW
पीना	P IY N AA
रीति	R IY T IH
रोज्रा	R OW JH R AA
हड्डियां	HH AH D D IH Y AA N
बकुल	B AH K UH L
मार्गदर्शक	M AA R G AH D AH R SH AH K
यज्ञ	Y AH G Y
इसलिये	IH S AH L IH Y EY
लुक	L UH K
जिओनी	JH IH OW N IY
कार्बन	K AA R B AH N
चौरासी	CH AO R AA S IY
सिखाई	S IH K HH AA IY
विधान	W IH DH AA N
गति	G AH T IH
गन्ने	G AH N N EY
उनके	UH N AH K EY
मल्होत्रा	M AH L HH OW T R AA
एग्जॉस्ट	EY G JH AO S T
बिल्लियां	B IH L L IH Y AA N
चाहते	CH AA HH AH T EY
महाराज	M AH HH AA R AA JH
ढोलक	DH OW L AH K
नाट्य	N AA T Y
लियाकत	L IH Y AA K AH T
पता	P AH T AA
बार्स	B AA R S
लगभग	L AH G AH B HH AH G
प्रोडक्ट्स	P R OW D AH K T S
ऑन	AO N
भरण	B HH AH R AH N
हातिम	HH AA T IH M
संध्या	S AH N DH Y AA
गोदान	G OW D AA N
शफ़ी	SH AH F IY
गोवा	G OW W AA
मर्क्यूरी	M AH R K Y UW R IY
बहुभाषी	B AH HH UH B HH AA SH IY
गधे	G AH DH EY
वैल्डिंग	W AE L D IH N G
महाराजा	M AH HH AA R AA JH AA
छत	CH AH T
प्राइम	P R AA IH M
अजी	AH JH IY
श्रीखंड	SH R IY K HH AH N D
प्रिंटर	P R IH N T AH R
मेजर	M EY JH AH R
पागलपन	P AA G AH L AH P AH N
सूख	S UW K HH
आये	AA Y EY
ओपेल	OW P EY L
रमेश	R AH M EY SH
अन्त	AH N T
डिवाइस	D IH W AA IH S
लोमड़ी	L OW M AH D IY
आकार	AA K AA R
बिल	B IH L
विलाज़	W IH L AA JH
कहने	K AH HH AH N EY
बड़े	B AH D EY
डाश	D AA SH
धागा	DH AA G AA
सामान	S AA M AA N
लाइ	L AA IH
डॉट	D AO T
घूमने	G HH UW M AH N EY
चटनी	CH AH T AH N IY
अमेरिकन	AH M EY R IH K AH N
अन्ताक्षरी	AH N T AA K SH AH R IY
रेबन	R EY B AH N
रूचि	R UW CH IH
पंक्चर	P AH N K CH AH R
मजदूर	M AH JH AH D UW R
उफ	UH F
कार्ड्स	K AA R D S
मानस	M AA N AH S
सब्जी	S AH B JH IY
डिजिटल	D IH JH IH T AH L
अपडेट	AH P AH D EY T
उदयपुर	UH D AH Y AH P UH R
डेज़	D EY JH
लकड़बग्घा	L AH K AH D B AH G G HH AA
एग्जीक्यूटिव	EY G JH IY K Y UW T IH W
बुर्का	B UH R K AA
बुलेट	B UH L EY T
बूट	B UW T
रामायण	R AA M AA Y AH N
प्रवचन	P R AH W AH CH AH N
स्क्रब्स	S K R AH B S
निर्मला	N IH R M AH L AA
बादाम	B AA D AA M
बजाता	B AH JH AA T AA
क्या	K Y AA
त्रिफला	T R IH F AH L AA
सारे	S AA R EY
उर्दू	UH R D UW
ट्राउजर्स	T R AA UH JH AH R S
मृत्यूंजय	M R IH T Y UW N JH AH Y
सेठिया	S EY TH IH Y AA
स्थानों	S TH AA N OW N
पेटी	P EY T IY
ड्रेस	D R EY S
साधु	S AA DH UH
लेहेंगा	L EY HH EY N G AA
आसमान	AA S AH M AA N
मंचन	M AH N CH AH N
अल्ट्रा	AH L T R AA
चढ़ाइयां	CH AH DH AA IH Y AA N
बैठ	B AE TH
ब्लूटूथ	B L UW T UW TH
बनवाने	B AH N AH W AA N EY
थाईलैंड	TH AA IY L AE N D
पास्टा	P AA S T AA
टुल्लू	T UH L L UW
फूल	F UW L
तीव्र	T IY W R
लीला	L IY L AA
श्रृंगार	SH R R IH N G AA R
फौजदारी	F AO JH AH D AA R IY
सांख्यिकी	S AA N K HH Y IH K IY
गूंथने	G UW N TH AH N EY
वोह	W OW HH
इजी	IH JH IY
पूरा	P UW R AA
झमेले	ZH AH M EY L EY
औपचारिक	AO P AH CH AA R IH K
ऐसा	AE S AA
कम	K AH M
चुका	CH UH K AA
सिद्धनाथ	S IH D DH AH N AA TH
नो	N OW
हेअर	HH EY AH R
पेंडुलम	P EY N D UH L AH M
मटिरियल्स	M AH T IH R IH Y AH L S
अंदाज	AH N D AA JH
जीप	JH IY P
बेस्ट	B EY S T
मानव	M AA N AH W
जेटली	JH EY T AH L IY
फैन	F AE N
उद्योग	UH D Y OW G
ऍब्सोल्यूट	B S OW L Y UW T
मैट	M AE T
नयी	N AH Y IY
पड़े	P AH D EY
इलेक्ट्रॉनिक	IH L EY K T R AO N IH K
अपमानजनक	AH P AH M AA N AH JH AH N AH K
घोषणा	G HH OW SH AH N AA
नंबर	N AH M B AH R
एलीफेंट	EY L IY F EY N T
रोज़	R OW JH
विजय	W IH JH AH Y
एक्सर्साइजर	EY K S AH R S AA IH JH AH R
शरबत	SH AH R AH B AH T
मिलने	M IH L AH N EY
आधे	AA DH EY
होम	HH OW M
फ्री	F R IY
झीओमी	ZH IY OW M IY
मालिश	M AA L IH SH
पुणे	P UH N EY
ईंट	IY N T
सर्टिफाइसेशन्स	S AH R T IH F AA IH S EY SH AH N S
सैटेलाइट	S AE T EY L AA IH T
आता	AA T AA
कमोड	K AH M OW D
प्लास्टिक्स	P L AA S T IH K S
लुजर	L UH JH AH R
इक्कीस	IH K K IY S
व्हिस्पर	W HH IH S P AH R
पयुमा	P AH Y UH M AA
गये	G AH Y EY
ज्युसर	JH Y UH S AH R
नाहीं	N AA HH IY N
एम्पलीफायर	EY M P AH L IY F AA Y AH R
पूरे	P UW R EY
वायुपुत्राची	W AA Y UH P UH T R AA CH IY
टैबलेट	T AE B AH L EY T
फिलिप्स	F IH L IH P S
सिक्स	S IH K S
मोबाइल्स	M OW B AA IH L S
दाग	D AA G
महाराष्ट्रीयन	M AH HH AA R AA SH T R IY Y AH N
मारुति	M AA R UH T IH
एक्सटेंडेड	EY K S AH T EY N D EY D
थोड़ी	TH OW D IY
रोका	R OW K AA
ओलंपिक्स	OW L AH M P IH K S
किड्स	K IH D S
पेंट	P EY N T
अख़बारों	AH K HH B AA R OW N
कालिया	K AA L IH Y AA
प्रवीण	P R AH W IY N
गुरूजी	G UH R UW JH IY
जाने	JH AA N EY
ऍड्वेंचर	D W EY N CH AH R
जिनके	JH IH N AH K EY
लैहेंगा	L AE HH EY N G AA
सुर	S UH R
गुब्बारे	G UH B B AA R EY
टेक्नोलॉजी	T EY K N OW L AO JH IY
हिंदी	HH IH N D IY
फतेहचंद	F AH T EY HH AH CH AH N D
पेन	P EY N
कपूर	K AH P UW R
मुफ्ती	M UH F T IY
एसूस	EY S UW S
आत्मकथा	AA T M AH K AH TH AA
नहीं	N AH HH IY N
नौवारी	N AO W AA R IY
शीत	SH IY T
फाउंडेशन	F AA UH N D EY SH AH N
नक़्शे	N AH K SH EY
सूती	S UW T IY
घागरा	G HH AA G AH R AA
बोल	B OW L
पुलिस	P UH L IH S
कुशंस	K UH SH AH N S
घंटी	G HH AH N T IY
टाइगर	T AA IH G AH R
कॉस्मेटिक्स	K AO S M EY T IH K S
हिंगलिश	HH IH N G AH L IH SH
टायर	T AA Y AH R
प्रश्नसंच	P R AH SH N AH S AH N CH
समझौता	S AH M AH ZH AO T AA
मेट	M EY T
अपो	AH P OW
वेअर	W EY AH R
दर्जे	D AH R JH EY
योगी	Y OW G IY
टुकड़े	T UH K AH D EY
विषारद	W IH SH AA R AH D
मरो	M AH R OW
थक	TH AH K
टोली	T OW L IY
बुद्धिजीवी	B UH D DH IH JH IY W IY
गईं	G IY N
सरकार	S AH R AH K AA R
सिक्सटीन	S IH K S AH T IY N
रैड	R AE D
हिल्टन	HH IH L T AH N
दिखा	D IH K HH AA
टूर्स	T UW R S
सिंथेटीक	S IH N TH EY T IY K
माता	M AA T AA
सेंतमेंत	S EY N T AH M EY N T
सूखे	S UW K HH EY
शिवकुमार	SH IH W AH K UH M AA R
जे	JH EY
भागवतराव	B HH AA G AH W AH T AH R AA W
सोमवार	S OW M AH W AA R
इन्डोनेशिया	IH N D OW N EY SH IH Y AA
डेकोरेशन	D EY K OW R EY SH AH N
देख	D EY K HH
बुरा	B UH R AA
झंडु	ZH AH N D UH
घी	G HH IY
खरीद	K HH AH R IY D
जानता	JH AA N AH T AA
कंगन	K AH N G AH N
ऑनलाइन	AO N AH L AA IH N
सबकुछ	S AH B AH K UH CH
अमृत	AH M R IH T
रिंग्स	R IH N G S
टॉकीज़	T AO K IY JH
थर्टीन	TH AH R T IY N
महत्वपूर्ण	M AH HH AH T W AH P UW R N
खूबसूरत	K HH UW B AH S UW R AH T
कागज़	K AA G AH JH
इकॉनमी	IH K AO N AH M IY
अब	AH B
कूकर	K UW K AH R
पाताल	P AA T AA L
चुप्पी	CH UH P P IY
पब्लिकेशन	P AH B L IH K EY SH AH N
जिस्ट	JH IH S T
गेनर	G EY N AH R
उपस्थित	UH P AH S TH IH T
खोदता	K HH OW D AH T AA
खत्म	K HH AH T M
लेना	L EY N AA
मिलते	M IH L AH T EY
फोग्ग	F OW G G
वैन	W AE N
विश्वास	W IH SH W AA S
ज्ञानोदय	G Y AA N OW D AH Y
इनकम	IH N AH K AH M
चाल	CH AA L
लगती	L AH G AH T IY
जीरी	JH IY R IY
गंभीर	G AH M B HH IY R
पालना	P AA L AH N AA
लघुता	L AH G HH UH T AA
एगलैस	EY G AH L AE S
आलू	AA L UW
ट्रक	T R AH K
राजेन्द्र	R AA JH EY N D R
आलोचना	AA L OW CH AH N AA
आए	AA EY
भुगतना	B HH UH G AH T AH N AA
ओन्ली	OW N L IY
वैदिक	W AE D IH K
सड़क	S AH D K
बिहार	B IH HH AA R
डिज़ाइनर	D IH JH AA IH N AH R
शहर	SH AH HH AH R
बची	B AH CH IY
दबाने	D AH B AA N EY
गंगा	G AH N G AA
नीरज	N IY R AH JH
वेबसाइटें	W EY B AH S AA IH T EY N
रख	R AH K HH
डिश	D IH SH
सफल	S AH F AH L
अप्रैल	AH P R AE L
रजाई	R AH JH AA IY
लहंगा	L AH HH AH N G AA
बयार	B AH Y AA R
जीवन	JH IY W AH N
हॉलिडे	HH AO L IH D EY
रिश्तौ	R IH SH T AO
गेट	G EY T
मिनी	M IH N IY
ख़लील	K HH L IY L
हुई	HH UH IY
स्लिपर्स	S L IH P AH R S
सस्ता	S AH S T AA
समझाया	S AH M AH ZH AA Y AA
विश्राम	W IH SH R AA M
गुहा	G UH HH AA
सकते	S AH K AH T EY
व्यवस्था	W Y AH W AH S TH AA
शून्य	SH UW N Y
ऐस	AE S
डीकाल्स	D IY K AA L S
कम्पास	K AH M P AA S
अरबों	AH R AH B OW N
उस्ताद	UH S T AA D
उसमें	UH S AH M EY N
सेन्सुई	S EY N S UH IY
पण्ढरपुर	P AH N DH AH R AH P UH R
कामों	K AA M OW N
ऊँट	UW N T
जगदीश	JH AH G AH D IY SH
बड़ा	B AH D AA
शुज	SH UH JH
जैक	JH AE K
कढ़ाई	K AH DH AA IY
यथार्थ	Y AH TH AA R TH
लिए	L IH EY
स्टोव	S T OW W
बी	B IY
संबंधों	S AH M B AH N DH OW N
फ्राक	F R AA K
बचपना	B AH CH AH P AH N AA
जिओ	JH IH OW
खंडन	K HH AH N D AH N
अफझल	AH F AH ZH AH L
पुस्तक	P UH S T AH K
लेज़र	L EY JH R
पजामा	P AH JH AA M AA
कायम	K AA Y AH M
दंग	D AH N G
डिस्काउंट	D IH S K AA UH N T
विचित्र	W IH CH IH T R
स्टेबलाइजर	S T EY B AH L AA IH JH AH R
गाय	G AA Y
क्लब	K L AH B
बड़ी	B AH D IY
मौर्या	M AO R Y AA
उम्र	UH M R
वापस	W AA P AH S
मुलतानी	M UH L AH T AA N IY
रुपयों	R UH P AH Y OW N
नेताओं	N EY T AA OW N
देशी	D EY SH IY
करा	K AH R AA
पैकेज	P AE K EY JH
वुमन	W UH M AH N
हनुमान	HH AH N UH M AA N
इंग्लैंड	IH N G L AE N D
अंकगणित	AH N K AH G AH N IH T
ताई	T AA IY
लक्ष्मी	L AH K SH M IY
बातें	B AA T EY N
ओरिएंट	OW R IH EY N T
कैलास	K AE L AA S
रहेगी	R AH HH EY G IY
गजेल	G AH JH EY L
क्रीम	K R IY M
नक्षत्रों	N AH K SH AH T R OW N
स्वरोच्चता	S W AH R OW CH CH AH T AA
जीन्स	JH IY N S
था	TH AA
कॅश	K SH
सोफ़ा	S OW F AA
टयूबलैस	T AH Y UW B AH L AE S
किया	K IH Y AA
अट्ठावन	AH T TH AA W AH N
दार	D AA R
कबर्ड	K AH B AH R D
हाइड्रौलिक	HH AA IH D R AO L IH K
चीप	CH IY P
आईओएस	AA IY OW EY S
क्लोदिंग	K L OW D IH N G
एक्वागार्ड	EY K W AA G AA R D
संक्षिप्त	S AH N K SH IH P T
ऑईल	AO IY L
राजकोट	R AA JH AH K OW T
खींचने	K HH IY N CH AH N EY
जोडा	JH OW D AA
वाल्व	W AA L W
चलेगा	CH AH L EY G AA
यूपीएस	Y UW P IY EY S
कॉटन	K AO T AH N
पद	P AH D
पंचायत	P AH N CH AA Y AH T
जीम	JH IY M
लगी	L AH G IY
टावर	T AA W AH R
मशीन	M AH SH IY N
बिलो	B IH L OW
वेधशाला	W EY DH AH SH AA L AA
चीन	CH IY N
सेलिओ	S EY L IH OW
को	K OW
कॉम्बो	K AO M B OW
बांधनी	B AA N DH AH N IY
इक्यावन	IH K Y AA W AH N
लेडीज़	L EY D IY JH
एक्वा	EY K W AA
आर्मी	AA R M IY
खेती	K HH EY T IY
पैकैट	P AE K AE T
बुद्धि	B UH D DH IH
मैजिक	M AE JH IH K
यशस्वी	Y AH SH AH S W IY
सिखा	S IH K HH AA
चप्पल्स	CH AH P P AH L S
शिलाजीत	SH IH L AA JH IY T
शू	SH UW
भाषाओँ	B HH AA SH AA OW N
बिंदु	B IH N D UH
कैमेरास	K AE M EY R AA S
गांधी	G AA N DH IY
अडैप्टर	AH D AE P T AH R
बजा	B AH JH AA
दवा	D AH W AA
फेन्सी	F EY N S IY
यूनिट	Y UW N IH T
सहायक	S AH HH AA Y AH K
किताबें	K IH T AA B EY N
लॉजीटैक	L AO JH IY T AE K
बैक	B AE K
कड़ी	K AH D IY
क्रिकेट	K R IH K EY T
तेरी	T EY R IY
लाइटें	L AA IH T EY N
आईरिस	AA IY R IH S
प्रीमियम	P R IY M IH Y AH M
पतंजली	P AH T AH N JH AH L IY
लेख	L EY K HH
ऋषि	R IH SH IH
रनिंग	R AH N IH N G
नैकलेस	N AE K AH L EY S
टैटू	T AE T UW
निकंदन	N IH K AH N D AH N
दर	D AH R
पढ़ायेंगे	P AH DH AA Y EY N G EY
सेंट	S EY N T
चिंतामणि	CH IH N T AA M AH N IH
मक्खन	M AH K K HH AH N
राजपूत	R AA JH AH P UW T
इंडिको	IH N D IH K OW
संसदीय	S AH N S AH D IY Y
नाशक	N AA SH AH K
मन्दिर	M AH N D IH R
अखरोट	AH K HH AH R OW T
कौआ	K AO AA
ओल्ड	OW L D
रामचन्द्र	R AA M AH CH AH N D R
शुभ	SH UH B HH
गंभीरता	G AH M B HH IY R AH T AA
हासिल	HH AA S IH L
उतना	UH T AH N AA
हाउस	HH AA UH S
गिरस्ती	G IH R AH S T IY
ग्लुकोज	G L UH K OW JH
बॉक्सर्स	B AO K S AH R S
पक्षियों	P AH K SH IH Y OW N
खुलेगा	K HH UH L EY G AA
बैंक	B AE N K
जाऊंगा	JH AA UW N G AA
कादंबरी	K AA D AH M B AH R IY
संतान	S AH N T AA N
जा	JH AA
तेईस	T EY IY S
गढ़े	G AH DH EY
मोदी	M OW D IY
आयोग	AA Y OW G
ओनिडा	OW N IH D AA
रुपये	R UH P AH Y EY
कटीग	K AH T IY G
काँच	K AA N CH
अनायास	AH N AA Y AA S
संभावना	S AH M B HH AA W AH N AA
कंम्पास	K AH N M P AA S
सप्टेम्बर	S AH P T EY M B AH R
वजह	W AH JH AH HH
बहाना	B AH HH AA N AA
तुम्हारे	T UH M HH AA R EY
है	HH AE
रहता	R AH HH AH T AA
मालदीव	M AA L AH D IY W
फल	F AH L
सिस्टम	S IH S T AH M
मास	M AA S
चरण	CH AH R AH N
इंडियन	IH N D IH Y AH N
फैमिली	F AE M IH L IY
काजू	K AA JH UW
लें	L EY N
फ्लोर	F L OW R
लओ	L OW
जोड़	JH OW D
स्विमिंग	S W IH M IH N G
दिमाग	D IH M AA G
जर्सी	JH AH R S IY
बंद	B AH N D
कपाट	K AH P AA T
वैष्णव	W AE SH N AH W
परिस्थितियों	P AH R IH S TH IH T IH Y OW N
परफ्युम	P AH R AH F Y UH M
डांसर	D AA N S AH R
व्यू	W Y UW
यूनाइटेड	Y UW N AA IH T EY D
चिल्ड्रन	CH IH L D R AH N
मिश्रा	M IH SH R AA
करना	K AH R AH N AA
साइंस	S AA IH N S
अपराध	AH P AH R AA DH
कागजात	K AA G AH JH AA T
सुनेजा	S UH N EY JH AA
फ्रॉग	F R AO G
स्नैपडील	S N AE P AH D IY L
आठ	AA TH
हफ्ते	HH AH F T EY
बीवी	B IY W IY
ट्रीट्मेंट	T R IY T M EY N T
हैवी	HH AE W IY
थानसिंह	TH AA N AH S IH N HH
हुवाइ	HH UH W AA IH
नौलखा	N AO L AH K HH AA
टेम्पल	T EY M P AH L
काइट्स	K AA IH T S
एशिया	EY SH IH Y AA
मस्किटो	M AH S K IH T OW
विवेचन	W IH W EY CH AH N
माधव	M AA DH AH W
सुल्तानी	S UH L T AA N IY
यूएसबी	Y UW EY S AH B IY
पायदान	P AA Y AH D AA N
एजुकेशनल	EY JH UH K EY SH AH N AH L
प्रवाह	P R AH W AA HH
रंग	R AH N G
एशियन	EY SH IH Y AH N
बीन	B IY N
हेड्फोन्स	HH EY D F OW N S
विज्ञान	W IH G Y AA N
कुओं	K UH OW N
भाग्य	B HH AA G Y
जाईये	JH AA IY Y EY
वैदेही	W AE D EY HH IY
लबालब	L AH B AA L AH B
रहती	R AH HH AH T IY
सभी	S AH B HH IY
मशीन्स	M AH SH IY N S
बुक	B UH K
वगैरह	W AH G AE R AH HH
मैसूर	M AE S UW R
फैंसी	F AE N S IY
वर्ष	W AH R SH
दिखने	D IH K HH AH N EY
दूध	D UW DH
टूटा	T UW T AA
फुली	F UH L IY
किला	K IH L AA
अद्भुत	AH D B HH UH T
माइक्रोवेव्स	M AA IH K R OW W EY W S
दफ्तर	D AH F T AH R
पैदा	P AE D AA
हज़	HH AH JH
उल्लू	UH L L UW
मुस्लिम	M UH S L IH M
बीयर	B IY Y AH R
स्लिम	S L IH M
मिल्खासिंह	M IH L K HH AA S IH N HH
समांतर	S AH M AA N T AH R
टिक	T IH K
एंड्	EY N D
गोरिला	G OW R IH L AA
निवास	N IH W AA S
लिवाइस	L IH W AA IH S
शीशा	SH IY SH AA
देने	D EY N EY
साधन	S AA DH AH N
जहां	JH AH HH AA N
तरह	T AH R AH HH
तोड़	T OW D
बाग	B AA G
तरीकों	T AH R IY K OW N
रिंगिंग	R IH N G IH N G
मंडप	M AH N D AH P
बडी़शोप	B AH D IY SH OW P
कितने	K IH T AH N EY
सीक्रेट	S IY K R EY T
तांत्रिक	T AA N T R IH K
ऑफर्स	AO F AH R S
तहखाने	T AH HH AH K HH AA N EY
छिपा	CH IH P AA
मेहता	M EY HH AH T AA
लोशन	L OW SH AH N
श्रीलंका	SH R IY L AH N K AA
मुक्ति	M UH K T IH
डैम	D AE M
पहली	P AH HH AH L IY
उषा	UH SH AA
धरती	DH AH R AH T IY
संस्कृति	S AH N S K R IH T IH
बहुत	B AH HH UH T
चौदह	CH AO D AH HH
हलवाई	HH AH L AH W AA IY
कसरत	K AH S AH R AH T
चिपके	CH IH P AH K EY
फ्लॉपी	F L AO P IY
पाक	P AA K
विटामिन	W IH T AA M IH N
बैड	B AE D
मुर्गी	M UH R G IY
औरंगाबाद	AO R AH N G AA B AA D
स्टिक	S T IH K
चौहत्तर	CH AO HH AH T T AH R
दिखावटी	D IH K HH AA W AH T IY
आराम	AA R AA M
कई	K IY
पिछले	P IH CH AH L EY
गाड़ी	G AA D IY
मराठी	M AH R AA TH IY
पारंगत	P AA R AH N G AH T
क्रोसिन	K R OW S IH N
चिनोज	CH IH N OW JH
जॉर्जट	JH AO R JH AH T
चौहान	CH AO HH AA N
पत्नी	P AH T N IY
प्रशंसा	P R AH SH AH N S AA
एयर	EY Y AH R
होम्योपैथी	HH OW M Y OW P AE TH IY
सिडीएमए	S IH D IY EY M EY
चैकआउट	CH AE K AA UH T
सुखाने	S UH K HH AA N EY
स्कूल	S K UW L
मैन्युअल	M AE N Y UH AH L
एच	EY CH
जोलो	JH OW L OW
मदद	M AH D AH D
विकट	W IH K AH T
उत्पत्ति	UH T P AH T T IH
प्राप्त	P R AA P T
आ	AA
बैग	B AE G
बूक्स	B UW K S
रुप	R UH P
रखा	R AH K HH AA
बिखर	B IH K HH AH R
पुरूषों	P UH R UW SH OW N
सार्वजनिक	S AA R W AH JH AH N IH K
रास	R AA S
सोल्ड	S OW L D
ड्रैस	D R AE S
तीन	T IY N
पूर्ण	P UW R N
इस्त्री	IH S T R IY
भाई	B HH AA IY
सर्दी	S AH R D IY
ऑडिओ	AO D IH OW
आटा	AA T AA
ए	EY
रेट	R EY T
जालीदार	JH AA L IY D AA R
सही	S AH HH IY
संवाद	S AH N W AA D
पे	P EY
डालूंगा	D AA L UW N G AA
फुटवियर	F UH T AH W IH Y AH R
बंसीलाल	B AH N S IY L AA L
बॉल	B AO L
लगते	L AH G AH T EY
सैट	S AE T
रशिया	R AH SH IH Y AA
जैकेट्स	JH AE K EY T S
धीरज	DH IY R AH JH
मेधा	M EY DH AA
श्रेया	SH R EY Y AA
चुनरी	CH UH N AH R IY
दूल्हे	D UW L HH EY
ढ़ेले	DH EY L EY
कीबोर्ड	K IY B OW R D
विविध	W IH W IH DH
क्यों	K Y OW N
कहता	K AH HH AH T AA
इमारत	IH M AA R AH T
इक्विप्मेंट	IH K W IH P M EY N T
साड़ी	S AA D IY
आशीर्वाद	AA SH IY R W AA D
शब्दावली	SH AH B D AA W AH L IY
कर्जे	K AH R JH EY
अप्सरा	AH P S AH R AA
सोवियत	S OW W IH Y AH T
तुलसीदास	T UH L AH S IY D AA S
नागाज़	N AA G AA JH
बताइये	B AH T AA IH Y EY
चाहिए	CH AA HH IH EY
ना	N AA
प्रोजेक्टर	P R OW JH EY K T AH R
करिए	K AH R IH EY
ट्रैकसूट	T R AE K AH S UW T
जान	JH AA N
एअरपोर्ट	EY AH R AH P OW R T
हिन्दुस्तान	HH IH N D UH S T AA N
पंत्र	P AH N T R
हार्मोनियम	HH AA R M OW N IH Y AH M
कट	K AH T
भूमि	B HH UW M IH
उच्च	UH CH CH
पेमेन्ट	P EY M EY N T
पोदीना	P OW D IY N AA
देना	D EY N AA
नोटबुक	N OW T AH B UH K
महापुराण	M AH HH AA P UH R AA N
ब्रिगेडियर	B R IH G EY D IH Y AH R
निविआ	N IH W IH AA
प्रतिनिधि	P R AH T IH N IH DH IH
मिर्च	M IH R CH
चलाना	CH AH L AA N AA
कृषि	K R IH SH IH
झमेलों	ZH AH M EY L OW N
और	AO R
व्हेल	W HH EY L
अमरीका	AH M AH R IY K AA
फॉर्मल	F AO R M AH L
रैपीडैक्स	R AE P IY D AE K S
ऐक्टिव	AE K T IH W
स्पाई	S P AA IY
संस्था	S AH N S TH AA
उसे	UH S EY
अमन	AH M AH N
टच	T AH CH
ग्रामोद्योग	G R AA M OW D Y OW G
बर्नर	B AH R N AH R
पंचनामा	P AH N CH AH N AA M AA
फैन्स	F AE N S
परती	P AH R AH T IY
फ्यूजी	F Y UW JH IY
सेल्फ़ी	S EY L F IY
फलों	F AH L OW N
पालने	P AA L AH N EY
बनवाना	B AH N AH W AA N AA
देहात	D EY HH AA T
आसान	AA S AA N
आरोप	AA R OW P
कप	K AH P
कहाँ	K AH HH AA N
श्रीरामचरित	SH R IY R AA M AH CH AH R IH T
हेल्थ	HH EY L TH
उकेरते	UH K EY R AH T EY
नाट्यगृह	N AA T Y AH G R IH HH
देखते	D EY K HH AH T EY
कमीज़	K AH M IY JH
पॉड	P AO D
निराशा	N IH R AA SH AA
लिटर	L IH T AH R
टैक्स	T AE K S
ब्लाउज़	B L AA UH JH
धूमकेतु	DH UW M AH K EY T UH
राष्ट्राध्यक्ष	R AA SH T R AA DH Y AH K SH
चिल्लाते	CH IH L L AA T EY
तरुण	T AH R UH N
निष्पक्षता	N IH SH P AH K SH AH T AA
वाईफाई	W AA IY F AA IY
कौटुंबिक	K AO T UH M B IH K
मिलती	M IH L AH T IY
मिलाते	M IH L AA T EY
दागीने	D AA G IY N EY
बॉश	B AO SH
ढोकला	DH OW K AH L AA
अपनाना	AH P AH N AA N AA
पा	P AA
जैमस्टोन	JH AE M AH S T OW N
ताला	T AA L AA
कृपया	K R IH P AH Y AA
अथवा	AH TH AH W AA
कनकौए	K AH N AH K AO EY
सेलो	S EY L OW
जहाज़	JH AH HH AA JH
खाक	K HH AA K
पड़ती	P AH D T IY
कोई	K OW IY
टीशर्ट्स	T IY SH AH R T S
हवाई	HH AH W AA IY
प्रक्रिया	P R AH K R IH Y AA
जिसने	JH IH S AH N EY
हेयर	HH EY Y AH R
बुद्धिमत्तापूर्ण	B UH D DH IH M AH T T AA P UW R N
खोज	K HH OW JH
समझ	S AH M AH ZH
चाइनीज़	CH AA IH N IY JH
वर्ण	W AH R N
नैरो	N AE R OW
मिखाइल	M IH K HH AA IH L
सकारात्मक	S AH K AA R AA T M AH K
यों	Y OW N
ज्ञानप्रकाश	G Y AA N AH P R AH K AA SH
डोंग	D OW N G
चुनाव	CH UH N AA W
मेल	M EY L
कह	K AH HH
हूँ	HH UW N
मफ्लर्स	M AH F L AH R S
बस्त	B AH S T
बुरे	B UH R EY
वोल्टेज	W OW L T EY JH
सरल	S AH R AH L
नैशनल	N AE SH AH N AH L
एल्मंड्स	EY L M AH N D S
वीकली	W IY K AH L IY
रिमुवर्स	R IH M UH W AH R S
ग्राम	G R AA M
मानते	M AA N AH T EY
वूडन	W UW D AH N
बढ़ी	B AH DH IY
एसेन्स	EY S EY N S
राख	R AA K HH
मछली	M AH CH AH L IY
काफ़ी	K AA F IY
बुद्धिमत्ता	B UH D DH IH M AH T T AA
सजावटी	S AH JH AA W AH T IY
थ्री	TH R IY
अहसास	AH HH AH S AA S
चन्द्र	CH AH N D R
कमी	K AH M IY
स्लीव्स	S L IY W S
कामत	K AA M AH T
रोज	R OW JH
डी	D IY
हलवानी	HH AH L AH W AA N IY
वीडियो	W IY D IH Y OW
जनक	JH AH N AH K
कुछ	K UH CH
विश्वामित्र	W IH SH W AA M IH T R
सायकल	S AA Y AH K AH L
जीतेन्द्र	JH IY T EY N D R
वात्सायन	W AA T S AA Y AH N
यामिनी	Y AA M IH N IY
कुरता	K UH R AH T AA
देखनेवाले	D EY K HH AH N EY W AA L EY
प्रदान	P R AH D AA N
गिरदावर	G IH R AH D AA W AH R
जुली	JH UH L IY
ज़िन्दा	JH IH N D AA
नेट	N EY T
गाऊन	G AA UW N
पास	P AA S
प्रातःकाल	P R AA T K AA L
फ्रॉक्स	F R AO K S
तब	T AH B
प्रभु	P R AH B HH UH
विद	W IH D
डॉक्टरों	D AO K T AH R OW N
आगे	AA G EY
जैसी	JH AE S IY
टीपी	T IY P IY
मृत	M R IH T
पालक	P AA L AH K
छूट	CH UW T
शाओमी	SH AA OW M IY
रही	R AH HH IY
वेरिको	W EY R IH K OW
बनकर	B AH N AH K AH R
बन	B AH N
भाषा	B HH AA SH AA
डीवीडी	D IY W IY D IY
रूपल्ली	R UW P AH L L IY
चम्पकलाल	CH AH M P AH K AH L AA L
फेस	F EY S
सिद्ध	S IH D DH
नमस्ते	N AH M AH S T EY
डमरू	D AH M AH R UW
हारमोनियम	HH AA R AH M OW N IH Y AH M
श्रोताओं	SH R OW T AA OW N
चाइनीज	CH AA IH N IY JH
जबकि	JH AH B AH K IH
सरपंच	S AH R AH P AH N CH
जोड़कर	JH OW D K AH R
दिखाइए	D IH K HH AA IH EY
चलते	CH AH L AH T EY
औसीलेटर	AO S IY L EY T AH R
पल्सर	P AH L S AH R
मैंजु	M AE N JH UH
बरसों	B AH R AH S OW N
सी	S IY
इलेक्ट्रिक	IH L EY K T R IH K
दुकान	D UH K AA N
रंगोली	R AH N G OW L IY
लोफर	L OW F AH R
अप्ग्रेड	AH P G R EY D
छोड़	CH OW D
शर्ट्स	SH AH R T S
लक्षद्वीप	L AH K SH AH D W IY P
साहब	S AA HH AH B
ट्रैवल	T R AE W AH L
फक्त	F AH K T
बत्ती	B AH T T IY
खर्च	K HH AH R CH
हुवर	HH UH W AH R
बने	B AH N EY
फ्लावर	F L AA W AH R
बाथ	B AA TH
ड्यूअल	D Y UW AH L
जॉकी	JH AO K IY
खरीदना	K HH AH R IY D AH N AA
साड़ीज़	S AA D IY JH
विक्रांत	W IH K R AA N T
तेल	T EY L
लेखा	L EY K HH AA
अवचेतन	AH W AH CH EY T AH N
सैंट	S AE N T
पोशाख	P OW SH AA K HH
यात्रा	Y AA T R AA
हॉर्न	HH AO R N
जिसके	JH IH S AH K EY
वेइंग	W EY IH N G
जैन	JH AE N
क्रोध	K R OW DH
इतने	IH T AH N EY
बगीचे	B AH G IY CH EY
भैरव	B HH AE R AH W
बवाल	B AH W AA L
बाकी	B AA K IY
गरिमा	G AH R IH M AA
इंडिया	IH N D IH Y AA
मचा	M AH CH AA
बजाज	B AH JH AA JH
थैली	TH AE L IY
बाथरूम	B AA TH AH R UW M
जमाने	JH AH M AA N EY
प्युरीफायर	P Y UH R IY F AA Y AH R
वॉचेज़	W AO CH EY JH
नुस्खे	N UH S K HH EY
सोडा	S OW D AA
दीवार	D IY W AA R
दिखाकर	D IH K HH AA K AH R
बैल्ट	B AE L T
माहेश्वरी	M AA HH EY SH W AH R IY
डिज़ाईन	D IH JH AA IY N
टपरी	T AH P AH R IY
कैनवास	K AE N AH W AA S
नसीब	N AH S IY B
हिन्दुस्तानी	HH IH N D UH S T AA N IY
प्रयोग	P R AH Y OW G
जानवर	JH AA N AH W AH R
पोर्टफोलियो	P OW R T AH F OW L IH Y OW
संजय	S AH N JH AH Y
विदेह	W IH D EY HH
इंजीनियरिंग	IH N JH IY N IH Y AH R IH N G
सीबर्ड	S IY B AH R D
पटाखे	P AH T AA K HH EY
बबूल	B AH B UW L
उसी	UH S IY
ब्लॉसम	B L AO S AH M
मात्रा	M AA T R AA
ज्यादा	JH Y AA D AA
ईश्वर	IY SH W AH R
हमारे	HH AH M AA R EY
स्वामी	S W AA M IY
बास्केट्बॉल	B AA S K EY T B AO L
वी	W IY
जायेंगे	JH AA Y EY N G EY
मंथली	M AH N TH AH L IY
बैठा	B AE TH AA
हेलमेट	HH EY L AH M EY T
कहना	K AH HH AH N AA
गैस	G AE S
इंटेल	IH N T EY L
रस	R AH S
परीक्षा	P AH R IY K SH AA
कॉस्ट	K AO S T
बिल्लियों	B IH L L IH Y OW N
छब्बीस	CH AH B B IY S
क्वॉलिटी	K W AO L IH T IY
रानी	R AA N IY
कामताप्रसाद	K AA M AH T AA P R AH S AA D
गले	G AH L EY
उज्जैन	UH JH JH AE N
गणदेविया	G AH N AH D EY W IH Y AA
सीरम	S IY R AH M
इलेक्ट्रिकल	IH L EY K T R IH K AH L
प्रेसिडेंट	P R EY S IH D EY N T
रघु	R AH G HH UH
एसी	EY S IY
जुते	JH UH T EY
मैमरी	M AE M AH R IY
उन्हें	UH N HH EY N
मफलर	M AH F AH L AH R
अनार	AH N AA R
विठोबा	W IH TH OW B AA
स्क्रैच	S K R AE CH
गिरेगी	G IH R EY G IY
जाओ	JH AA OW
सॉस	S AO S
निकले	N IH K AH L EY
हैडफ़ोन	HH AE D AH F OW N
घूंटी	G HH UW N T IY
अनुरुप	AH N UH R UH P
धरी	DH AH R IY
वनस्पति	W AH N AH S P AH T IH
अंग्रेजी	AH N G R EY JH IY
घड़ियाँ	G HH AH D IH Y AA N
गीत	G IY T
आकांक्षा	AA K AA N K SH AA
संसार	S AH N S AA R
दरोबस्त	D AH R OW B AH S T
कोऊ	K OW UW
आया	AA Y AA
अन्धा	AH N DH AA
सेवा	S EY W AA
ऑटो	AO T OW
लिमये	L IH M AH Y EY
भाषण	B HH AA SH AH N
पाटील	P AA T IY L
पैलेस	P AE L EY S
पैनासोनिक	P AE N AA S OW N IH K
रट	R AH T
कोल्ड	K OW L D
इज्ज़त	IH JH JH T
रेलवे	R EY L AH W EY
हृदय	HH R IH D AH Y
कार्यक्रमों	K AA R Y AH K R AH M OW N
हैल्प	HH AE L P
बनेगा	B AH N EY G AA
भूख	B HH UW K HH
हर	HH AH R
सूची	S UW CH IY
बैंजो	B AE N JH OW
इन्शुरैंस	IH N SH UH R AE N S
हॉटेल	HH AO T EY L
गांव	G AA N W
लैंप	L AE M P
जब	JH AH B
किताबघर	K IH T AA B AH G HH AH R
थम	TH AH M
खेतीबाड़ी	K HH EY T IY B AA D IY
राजसूय	R AA JH AH S UW Y
निष्पक्ष	N IH SH P AH K SH
लेन	L EY N
मोज़र	M OW JH R
डेस्कटॉप	D EY S K AH T AO P
मुवीज	M UH W IY JH
हात	HH AA T
बल	B AH L
टाउन	T AA UH N
टॉप्स	T AO P S
विचारों	W IH CH AA R OW N
विचारक	W IH CH AA R AH K
दबाव	D AH B AA W
जूता	JH UW T AA
वालपेपर	W AA L AH P EY P AH R
किधर	K IH DH AH R
जिंस	JH IH N S
फॅमिली	F M IH L IY
होंगे	HH OW N G EY
सिम्फनी	S IH M F AH N IY
चलता	CH AH L AH T AA
छह	CH AH HH
ऑफ़	AO F
सिंगर	S IH N G AH R
अठारह	AH TH AA R AH HH
वूलन	W UW L AH N
सूर्यकांत	S UW R Y AH K AA N T
लेखक	L EY K HH AH K
एसडी	EY S AH D IY
सारी	S AA R IY
कब	K AH B
स्मार्ट	S M AA R T
दलों	D AH L OW N
सजावट	S AH JH AA W AH T
चाचा	CH AA CH AA
किसी	K IH S IY
पॉप्स	P AO P S
सिप्ला	S IH P L AA
क्षत्रिय	K SH AH T R IH Y
संगत	S AH N G AH T
कर्ज़	K AH R JH
शिकंजी	SH IH K AH N JH IY
पर्याय	P AH R Y AA Y
दागिने	D AA G IH N EY
टीशर्ट	T IY SH AH R T
रामदेव	R AA M AH D EY W
टूथ	T UW TH
चुराने	CH UH R AA N EY
ऑफिस	AO F IH S
डॉग	D AO G
वाक्य	W AA K Y
मुर्दाबाद	M UH R D AA B AA D
रेडिमेट	R EY D IH M EY T
धब्बों	DH AH B B OW N
वेडिंग	W EY D IH N G
सिल्क	S IH L K
एचडी	EY CH AH D IY
जेंट्स	JH EY N T S
वार्डरोब	W AA R D AH R OW B
स्थापित	S TH AA P IH T
चितले	CH IH T AH L EY
चौबीस	CH AO B IY S
कुर्तीज	K UH R T IY JH
रूम	R UW M
अफजल	AH F AH JH AH L
ग्रे	G R EY
पी	P IY
स्टोर	S T OW R
सार	S AA R
बावजूद	B AA W AH JH UW D
यू	Y UW
ट्रिमर्स	T R IH M AH R S
आपके	AA P AH K EY
समझेगा	S AH M AH ZH EY G AA
भेज	B HH EY JH
नाइके	N AA IH K EY
कोर	K OW R
मेडिसिन्स	M EY D IH S IH N S
राजेश	R AA JH EY SH
माला	M AA L AA
पाटिल	P AA T IH L
शर्मा	SH AH R M AA
आउटरवियर	AA UH T AH R AH W IH Y AH R
आनेकी	AA N EY K IY
नूर	N UW R
बदलती	B AH D AH L AH T IY
शरीर	SH AH R IY R
राव	R AA W
सोनू	S OW N UW
दिनरात	D IH N AH R AA T
एवरी	EY W AH R IY
साइकल	S AA IH K AH L
रखकर	R AH K HH AH K AH R
पोस्टपेड	P OW S T AH P EY D
स्वयं	S W AH Y AH N
संयोग	S AH N Y OW G
दुय्यम	D UH Y Y AH M
केयरफ्री	K EY Y AH R AH F R IY
होगा	HH OW G AA
अबव	AH B AH W
जूतियाँ	JH UW T IH Y AA N
महंगा	M AH HH AH N G AA
पकड़ने	P AH K AH D N EY
ऐम्बर	AE M B AH R
कभी	K AH B HH IY
रिचार्ज	R IH CH AA R JH
दिगंबर	D IH G AH M B AH R
डीलक्स	D IY L AH K S
चौपन	CH AO P AH N
ऐसे	AE S EY
हुआ	HH UH AA
द	D
दिनेश	D IH N EY SH
चलो	CH AH L OW
अक्ल	AH K L
बढ़ने	B AH DH N EY
उड़ा	UH D AA
भगवन	B HH AH G AH W AH N
तोशिबा	T OW SH IH B AA
सिओल	S IH OW L
पिया	P IH Y AA
विकल्प	W IH K AH L P
महसूल	M AH HH AH S UW L
मत	M AH T
मिला	M IH L AA
वायफाय	W AA Y AH F AA Y
समर्थ	S AH M AH R TH
कुर्ताज	K UH R T AA JH
केले	K EY L EY
एलजी	EY L AH JH IY
बागवानी	B AA G AH W AA N IY
वन	W AH N
ग्रेट	G R EY T
वाइब्रेटर	W AA IH B R EY T AH R
तैयारी	T AE Y AA R IY
सम्मानित	S AH M M AA N IH T
रगड़ने	R AH G AH D N EY
टू	T UW
चलने	CH AH L AH N EY
दीया	D IY Y AA
नांदेड	N AA N D EY D
बीमार	B IY M AA R
कूकीज़	K UW K IY JH
खाने	K HH AA N EY
जुता	JH UH T AA
वॉटर	W AO T AH R
पुखराज	P UH K HH AH R AA JH
चॉकलेट्स	CH AO K AH L EY T S
अत	AH T
पेस्ट	P EY S T
गांववालों	G AA N W AH W AA L OW N
कपास	K AH P AA S
चमड़े	CH AH M AH D EY
बॉय्ज	B AO Y JH
हल्दी	HH AH L D IY
रेडियो	R EY D IH Y OW
चाहे	CH AA HH EY
चौरंगी	CH AO R AH N G IY
गुप्ती	G UH P T IY
बेड	B EY D
वैवाहिक	W AE W AA HH IH K
आरोह	AA R OW HH
बास	B AA S
ईनटैक्स	IY N AH T AE K S
बोलेगा	B OW L EY G AA
शावर	SH AA W AH R
गयौ	G AH Y AO
श्लोक	SH L OW K
जिस	JH IH S
व्यापार	W Y AA P AA R
क्रुद्ध	K R UH D DH
फोंस	F OW N S
दिये	D IH Y EY
गया	G AH Y AA
इसमें	IH S AH M EY N
शोज़	SH OW JH
स्पीकर्स	S P IY K AH R S
रतन	R AH T AH N
लीग	L IY G
टेलीफोन	T EY L IY F OW N
समान	S AH M AA N
काम	K AA M
वाचेज़	W AA CH EY JH
बच्चों	B AH CH CH OW N
श्लोकार्थ	SH L OW K AA R TH
या	Y AA
मारूती	M AA R UW T IY
शराबखोरी	SH AH R AA B AH K HH OW R IY
तमाम	T AH M AA M
दिया	D IH Y AA
रफूचक्कर	R AH F UW CH AH K K AH R
हाट	HH AA T
सलाह	S AH L AA HH
योजना	Y OW JH AH N AA
फूलवती	F UW L AH W AH T IY
पड़ता	P AH D T AA
जिहादी	JH IH HH AA D IY
कमान	K AH M AA N
स्टीक	S T IY K
मिलाकर	M IH L AA K AH R
चित्र	CH IH T R
जैसलमेर	JH AE S AH L AH M EY R
रचा	R AH CH AA
सुलह	S UH L AH HH
होटल	HH OW T AH L
कवर्स	K AH W AH R S
ईन	IY N
भरतपुर	B HH AH R AH T AH P UH R
पेट	P EY T
ट्राउज़र्स	T R AA UH JH R S
मैने	M AE N EY
दादाओं	D AA D AA OW N
सीधे	S IY DH EY
नौकरी	N AO K AH R IY
प्रताप	P R AH T AA P
बैठे	B AE TH EY
बताऊं	B AH T AA UW N
दवेकर	D AH W EY K AH R
टायटन	T AA Y AH T AH N
नेल	N EY L
इन्टरनेट	IH N T AH R AH N EY T
जाऊँगा	JH AA UW N G AA
इम्पोर्टेड	IH M P OW R T EY D
उनसे	UH N AH S EY
बारे	B AA R EY
कोंडुस्कर	K OW N D UH S K AH R
स्क्रीन	S K R IY N
झुमके	ZH UH M AH K EY
अगरबत्ती	AH G AH R AH B AH T T IY
गिरने	G IH R AH N EY
छोटे	CH OW T EY
मोटर्स	M OW T AH R S
ऊटी	UW T IY
नारायणदास	N AA R AA Y AH N AH D AA S
हेल्प	HH EY L P
मिलकर	M IH L AH K AH R
एक्स	EY K S
रहा	R AH HH AA
फ़ोटो	F OW T OW
अध्ययन	AH DH Y AH Y AH N
सूप	S UW P
शाऔमी	SH AA AO M IY
इंची	IH N CH IY
स्पोर्ट्स	S P OW R T S
चुनावी	CH UH N AA W IY
मेमोरी	M EY M OW R IY
वेल्डिंग	W EY L D IH N G
प्राप्ति	P R AA P T IH
पुडा	P UH D AA
उत्पादन	UH T P AA D AH N
गुलामगिरी	G UH L AA M AH G IH R IY
ज़्यादातर	JH Y AA D AA T AH R
समय	S AH M AH Y
कैप्सूल	K AE P S UW L
ऑटोव्हील	AO T OW W HH IY L
नेता	N EY T AA
टॉप	T AO P
क्रैक	K R AE K
कृपा	K R IH P AA
पचास	P AH CH AA S
पड़ी	P AH D IY
कालीन	K AA L IY N
जिन	JH IH N
विभाग	W IH B HH AA G
पिज़ा	P IH JH AA
अज्ञानता	AH G Y AA N AH T AA
नीक्कर	N IY K K AH R
बिम्लानी	B IH M L AA N IY
जामै	JH AA M AE
खयाल	K HH AH Y AA L
बुनियादी	B UH N IH Y AA D IY
कार्ड	K AA R D
बढ़ेगी	B AH DH EY G IY
बराबर	B AH R AA B AH R
वामनराव	W AA M AH N AH R AA W
सैंडल	S AE N D AH L
सलवार	S AH L AH W AA R
गाँधी	G AA N DH IY
ज़मीन	JH M IY N
जितनी	JH IH T AH N IY
पार्लर	P AA R L AH R
रत्न	R AH T N
टयूब्स	T AH Y UW B S
आसपास	AA S AH P AA S
अजित	AH JH IH T
ब्यूटी	B Y UW T IY
गोर्बाचेव	G OW R B AA CH EY W
इग्निशन	IH G N IH SH AH N
इतिहास	IH T IH HH AA S
सीडी	S IY D IY
डिक्सी	D IH K S IY
पटियाला	P AH T IH Y AA L AA
चाहता	CH AA HH AH T AA
निराला	N IH R AA L AA
बनाया	B AH N AA Y AA
स्मार्टफोंस	S M AA R T AH F OW N S
गिद्ध	G IH D DH
झूठ	ZH UW TH
यूफोरिया	Y UW F OW R IH Y AA
नोइडा	N OW IH D AA
वूमेन	W UW M EY N
प्रेस्टीज	P R EY S T IY JH
अभियान्त्रिकी	AH B HH IH Y AA N T R IH K IY
दूर	D UW R
सीख	S IY K HH
प्रतिक्रिया	P R AH T IH K R IH Y AA
सफ़ेद	S AH F EY D
मैं	M AE N
आइपैड	AA IH P AE D
उसने	UH S AH N EY
कॉलेज	K AO L EY JH
कैटाविल	K AE T AA W IH L
हंस	HH AH N S
परिवर्तन	P AH R IH W AH R T AH N
टाइम	T AA IH M
भाग	B HH AA G
लगाम	L AH G AA M
उपक्रम	UH P AH K R AH M
भलाई	B HH AH L AA IY
ड्रीम	D R IY M
स्टेथोस्कोप	S T EY TH OW S K OW P
एवं	EY W AH N
पदार्थों	P AH D AA R TH OW N
हिंदुस्तान	HH IH N D UH S T AA N
जांच	JH AA N CH
लैपटॉप	L AE P AH T AO P
वारंटी	W AA R AH N T IY
किफायत	K IH F AA Y AH T
अनुसार	AH N UH S AA R
गुल	G UH L
निकालेंगे	N IH K AA L EY N G EY
तुम	T UH M
प्रोसेसर	P R OW S EY S AH R
स्वदेशी	S W AH D EY SH IY
पायजामा	P AA Y AH JH AA M AA
जनरल	JH AH N AH R AH L
सोच	S OW CH
रुख़	R UH K HH
पाओगे	P AA OW G EY
मुरब्बा	M UH R AH B B AA
टॉकिंग	T AO K IH N G
भओ	B HH OW
हार्ड	HH AA R D
सीमा	S IY M AA
वैक्यूम	W AE K Y UW M
एलीगेटर	EY L IY G EY T AH R
विमान	W IH M AA N
अनेक	AH N EY K
ऊपर	UW P AH R
सौंदर्य	S AO N D AH R Y
चम्मच	CH AH M M AH CH
भी	B HH IY
मैच	M AE CH
भाईसाहब	B HH AA IY S AA HH AH B
चमत्कारिक	CH AH M AH T K AA R IH K
पीपल	P IY P AH L
चिलम	CH IH L AH M
इंकजैट	IH N K AH JH AE T
कंप्रेस्ड	K AH M P R EY S D
ऍब्डोमिनल	B D OW M IH N AH L
धनवानों	DH AH N AH W AA N OW N
सौन्दर्यशास्त्र	S AO N D AH R Y AH SH AA S T R
उनको	UH N AH K OW
कला	K AH L AA
हालात	HH AA L AA T
पाउडर	P AA UH D AH R
आँकड़ों	AA N K AH D OW N
कलेक्शन	K AH L EY K SH AH N
वेहिकल	W EY HH IH K AH L
टेरेन	T EY R EY N
टर्बो	T AH R B OW
स्टेनलेस	S T EY N AH L EY S
फोड़	F OW D
खाकर	K HH AA K AH R
ज़मीं	JH M IY N
पर्दे	P AH R D EY
सौतेला	S AO T EY L AA
की	K IY
साबित	S AA B IH T
पैसा	P AE S AA
नेकनामी	N EY K AH N AA M IY
घेरदार	G HH EY R AH D AA R
आश्चर्य	AA SH CH AH R Y
हॉकी	HH AO K IY
रेल्वे	R EY L W EY
एक्स्टर्नल	EY K S T AH R N AH L
बॉयज	B AO Y AH JH
बरसात	B AH R AH S AA T
नाथद्वारा	N AA TH AH D W AA R AA
छुरी	CH UH R IY
कंडीशनर	K AH N D IY SH AH N AH R
पुरानी	P UH R AA N IY
कर्मठ	K AH R M AH TH
गेम्स	G EY M S
निर्वहन	N IH R W AH HH AH N
घंटे	G HH AH N T EY
प्रिंटेड	P R IH N T EY D
हालत	HH AA L AH T
कलक्टर	K AH L AH K T AH R
विशेष	W IH SH EY SH
बेटा	B EY T AA
छंद	CH AH N D
मुझी	M UH ZH IY
हार	HH AA R
लेडीज	L EY D IY JH
ज्ञान	G Y AA N
चूहा	CH UW HH AA
किंग्स्टन	K IH N G S T AH N
पटपड़गंज	P AH T AH P AH D G AH N JH
सुनील	S UH N IY L
शेयर	SH EY Y AH R
शंखपुष्पी	SH AH N K HH AH P UH SH P IY
मोदानी	M OW D AA N IY
स्क्रू	S K R UW
थिंकपैड	TH IH N K AH P AE D
पालतू	P AA L AH T UW
साहेब	S AA HH EY B
ज्योतिष	JH Y OW T IH SH
मरुन	M AH R UH N
चोरी	CH OW R IY
ज़ेब्रोनिक्स	JH EY B R OW N IH K S
पूरी	P UW R IY
ग्रुप	G R UH P
एलइडी	EY L IH D IY
तकिये	T AH K IH Y EY
प्लेयर	P L EY Y AH R
बाईक	B AA IY K
रेशमी	R EY SH AH M IY
पड़यंत्र	P AH D Y AH N T R
मुख्य	M UH K HH Y
फेश	F EY SH
जयपुर	JH AH Y AH P UH R
सीधा	S IY DH AA
रबर	R AH B AH R
मसाला	M AH S AA L AA
भगवान	B HH AH G AH W AA N
कहानियाँ	K AH HH AA N IH Y AA N
स्कूटर्स	S K UW T AH R S
पंप	P AH M P
एप्लायंसेज	EY P L AA Y AH N S EY JH
गूगल	G UW G AH L
परिवार	P AH R IH W AA R
चाय	CH AA Y
स्कार्पियो	S K AA R P IH Y OW
दीजिये	D IY JH IH Y EY
शेक	SH EY K
कॉस्ट्यूम	K AO S T Y UW M
फलसफा	F AH L AH S AH F AA
बीच	B IY CH
पारित	P AA R IH T
शिकायत	SH IH K AA Y AH T
दवाएं	D AH W AA EY N
ऐतिहासिक	AE T IH HH AA S IH K
शिबिर	SH IH B IH R
हैयर	HH AE Y AH R
कण्ट्रोल	K AH N T R OW L
लिखी	L IH K HH IY
बघारना	B AH G HH AA R AH N AA
पहुंच	P AH HH UH N CH
फोटो	F OW T OW
टॉडलर	T AO D AH L AH R
एस	EY S
ग्रस्त	G R AH S T
ढाल	DH AA L
ऑपरेटिंग	AO P AH R EY T IH N G
झगड़ा	ZH AH G AH D AA
जोधपुरी	JH OW DH AH P UH R IY
ग्राइप	G R AA IH P
कोयल	K OW Y AH L
बम्पर	B AH M P AH R
डेनिम	D EY N IH M
फाउंटेन	F AA UH N T EY N
नाम	N AA M
इंतज़ार	IH N T AH JH AA R
महफ़िलों	M AH HH AH F IH L OW N
समूची	S AH M UW CH IY
उनका	UH N AH K AA
सेल्फी	S EY L F IY
प्रतियोगिता	P R AH T IH Y OW G IH T AA
पैक्स	P AE K S
सहायता	S AH HH AA Y AH T AA
नॉवेल	N AO W EY L
आदमियों	AA D AH M IH Y OW N
राज़	R AA JH
वजीफा	W AH JH IY F AA
छीनकर	CH IY N AH K AH R
ब्लेज़र	B L EY JH R
भर	B HH AH R
जिऔलॉजिकल	JH IH AO L AO JH IH K AH L
गायत्री	G AA Y AH T R IY
बुद्धिमता	B UH D DH IH M AH T AA
बनवा	B AH N AH W AA
कुबेर	K UH B EY R
अधिनियम	AH DH IH N IH Y AH M
सीलीग	S IY L IY G
ट्यूनिक्स	T Y UW N IH K S
स्काई	S K AA IY
सोरायोसिस	S OW R AA Y OW S IH S
तोड़कर	T OW D K AH R
धुआँ	DH UH AA N
बनारसी	B AH N AA R AH S IY
कि	K IH
सेट	S EY T
दृष्टिकोण	D R IH SH T IH K OW N
बर्तन	B AH R T AH N
साँप	S AA N P
स्टिच्ड	S T IH CH D
टूरिस्ट्स	T UW R IH S T S
व्हर्लपूल	W HH AH R L AH P UW L
होने	HH OW N EY
पॉवर	P AO W AH R
पॉवर(2)	P AO W ER
पॉवर(3)	P AA W AH R
पॉवर(4)	P AA W ER
हटाने	HH AH T AA N EY
एकड़	EY K AH D
रुपीज	R UH P IY JH
विंडोज़	W IH N D OW JH
बुकिंग	B UH K IH N G
पंखे	P AH N K HH EY
रोड	R OW D
चढ़	CH AH DH
बीपी	B IY P IY
साउंड	S AA UH N D
माफ़	M AA F
ट्रिमर	T R IH M AH R
स्ट्रैचेबल	S T R AE CH EY B AH L
जंगल	JH AH N G AH L
तीर्थयात्रा	T IY R TH AH Y AA T R AA
विवाद	W IH W AA D
जिब्रान	JH IH B R AA N
साहनी	S AA HH AH N IY
पेश	P EY SH
मधेशी	M AH DH EY SH IY
खिड़की	K HH IH D K IY
संस्कृत	S AH N S K R IH T
तार	T AA R
प्रसारित	P R AH S AA R IH T
जैकेट	JH AE K EY T
देव	D EY W
असुर	AH S UH R
चांदी	CH AA N D IY
लेहेंगाज़	L EY HH EY N G AA JH
देखने	D EY K HH AH N EY
कार्डिन	K AA R D IH N
स्किन	S K IH N
पशु	P AH SH UH
ग्रामर	G R AA M AH R
ओरिज्नल	OW R IH JH N AH L
अठासी	AH TH AA S IY
गरीब	G AH R IY B
अप	AH P
मटिरीयल	M AH T IH R IY Y AH L
राज्य	R AA JH Y
अंगोरिया	AH N G OW R IH Y AA
लिया	L IH Y AA
भोजन	B HH OW JH AH N
आर्टिफिशल	AA R T IH F IH SH AH L
मैनिक्यूर	M AE N IH K Y UW R
न्यू	N Y UW
बेराह	B EY R AA HH
ऊँचे	UW N CH EY
इन्श्यूरैंस	IH N SH Y UW R AE N S
हर्बल	HH AH R B AH L
महीने	M AH HH IY N EY
पंक्ति	P AH N K T IH
बे	B EY
हिम्मत	HH IH M M AH T
रॉड	R AO D
शुक्रवार	SH UH K R AH W AA R
महात्मा	M AH HH AA T M AA
रमणप्रकाश	R AH M AH N AH P R AH K AA SH
पिंक	P IH N K
सिगड़ी	S IH G AH D IY
पैनल्स	P AE N AH L S
सीखने	S IY K HH AH N EY
थाउज़ेंड	TH AA UH JH EY N D
चुकाए	CH UH K AA EY
ने	N EY
लेटेस्ट	L EY T EY S T
बोला	B OW L AA
डालते	D AA L AH T EY
पैसों	P AE S OW N
गंवाया	G AH N W AA Y AA
सहसा	S AH HH AH S AA
रेगुलर	R EY G UH L AH R
शिव	SH IH W
बच्चन	B AH CH CH AH N
प्रति	P R AH T IH
मधुबनी	M AH DH UH B AH N IY
ब्लोअर	B L OW AH R
गैलैक्सी	G AE L AE K S IY
तंत्र	T AH N T R
हल	HH AH L
शटर	SH AH T AH R
विज़न	W IH JH N
लाक्षागृह	L AA K SH AA G R IH HH
आर्डू	AA R D UW
कमर	K AH M AH R
रोलैक्स	R OW L AE K S
पिलो	P IH L OW
आओगे	AA OW G EY
भोपाल	B HH OW P AA L
पिगी	P IH G IY
अंदर	AH N D AH R
केंद्र	K EY N D R
दार्शनिक	D AA R SH AH N IH K
श्री	SH R IY
जलेसर	JH AH L EY S AH R
शूस	SH UW S
किले	K IH L EY
शज़र	SH AH JH R
क्लास	K L AA S
हॉबीज	HH AO B IY JH
सेल	S EY L
नोकिया	N OW K IH Y AA
सुंडा	S UH N D AA
मुल्तिचोलोउर	M UH L T IH CH OW L OW UH R
पीसने	P IY S AH N EY
रिबॉक	R IH B AO K
सस्ते	S AH S T EY
मनोहर	M AH N OW HH AH R
मानिए	M AA N IH EY
लेदर	L EY D AH R
हॉट	HH AO T
स्वास्थ्य	S W AA S TH Y
शिफॉन	SH IH F AO N
दुर्गेश	D UH R G EY SH
शास्त्रीजी	SH AA S T R IY JH IY
साथी	S AA TH IY
टी	T IY
गाता	G AA T AA
ब्रेक	B R EY K
डिपार्टमेंट	D IH P AA R T AH M EY N T
बृहद	B R IH HH AH D
होती	HH OW T IY
रेफ्रिजरेटर	R EY F R IH JH AH R EY T AH R
बल्ब्स	B AH L B S
पुष्पं	P UH SH P AH N
वाले	W AA L EY
शूज	SH UW JH
चनिया	CH AH N IH Y AA
लेकर	L EY K AH R
हॉस्पिटल	HH AO S P IH T AH L
फ्लाइट	F L AA IH T
माउस	M AA UH S
गिलाफ़	G IH L AA F
मिलता	M IH L AH T AA
बोय्ज़	B OW Y JH
बाईस	B AA IY S
ये	Y EY
मेहनत	M EY HH AH N AH T
ऐलोपैथी	AE L OW P AE TH IY
लूट	L UW T
संजीवनी	S AH N JH IY W AH N IY
रसोईघर	R AH S OW IY G HH AH R
शेविंग	SH EY W IH N G
लोगों	L OW G OW N
मुश्किल	M UH SH K IH L
कालरा	K AA L AH R AA
चिकित्सा	CH IH K IH T S AA
बैन्टेक्स	B AE N T EY K S
चंद्रा	CH AH N D R AA
पर्स	P AH R S
मां	M AA N
पसीना	P AH S IY N AA
सकें	S AH K EY N
प्रूफ्ड	P R UW F D
वायर	W AA Y AH R
धौली	DH AO L IY
दिन	D IH N
इंदौर	IH N D AO R
जीवित	JH IY W IH T
आधार	AA DH AA R
पुर्वान्करा	P UH R W AA N K AH R AA
इमली	IH M AH L IY
चरबी	CH AH R AH B IY
उपन्यास	UH P AH N Y AA S
वेबसाइट	W EY B AH S AA IH T
छीन	CH IY N
प्रकार	P R AH K AA R
असाढ़	AH S AA DH
साफी	S AA F IY
निभाया	N IH B HH AA Y AA
चन्दन	CH AH N D AH N
चूंकि	CH UW N K IH
हजार	HH AH JH AA R
सूट्स	S UW T S
अगले	AH G AH L EY
ओर्गेनिक	OW R G EY N IH K
मौसम	M AO S AH M
हरियाली	HH AH R IH Y AA L IY
बाप	B AA P
बिजली	B IH JH AH L IY
आपको	AA P AH K OW
शाकाहारी	SH AA K AA HH AA R IY
अंधा	AH N DH AA
वॉटरप्रूफ	W AO T AH R AH P R UW F
घटना	G HH AH T AH N AA
काड़ने	K AA D N EY
मेटल	M EY T AH L
बल्कि	B AH L K IH
विग	W IH G
बाधा	B AA DH AA
करता	K AH R AH T AA
वैसा	W AE S AA
गाँव	G AA N W
कौनसे	K AO N AH S EY
लाख	L AA K HH
कामरुप	K AA M AH R UH P
दफनाया	D AH F AH N AA Y AA
उतनी	UH T AH N IY
बाजू	B AA JH UW
उत्तीर्ण	UH T T IY R N
सेवन	S EY W AH N
लोक	L OW K
बेबीज	B EY B IY JH
शिवाजी	SH IH W AA JH IY
धोती	DH OW T IY
पकड़ा	P AH K AH D AA
करे	K AH R EY
वॉक्स	W AO K S
संरक्षण	S AH N R AH K SH AH N
दीपावली	D IY P AA W AH L IY
रिलायंस	R IH L AA Y AH N S
स्पोर्ट	S P OW R T
महान	M AH HH AA N
गलती	G AH L AH T IY
चाइना	CH AA IH N AA
लो	L OW
तहसील	T AH HH AH S IY L
हॉउस	HH AO UH S
सोलो	S OW L OW
हुगीज़	HH UH G IY JH
सरकारी	S AH R AH K AA R IY
हों	HH OW N
वेल्नेस	W EY L N EY S
चढ़ै	CH AH DH AE
बेल्ट	B EY L T
अर्थव्यवस्था	AH R TH AH W Y AH W AH S TH AA
विंडोज	W IH N D OW JH
रिपेलन्ट	R IH P EY L AH N T
बंगाली	B AH N G AA L IY
यहां	Y AH HH AA N
चलाता	CH AH L AA T AA
प्लेट	P L EY T
सिलीग	S IH L IY G
दूसरी	D UW S AH R IY
थे	TH EY
टॉय्ज़	T AO Y JH
हुऐ	HH UH AE
उछल	UH CH AH L
खिलाड़ी	K HH IH L AA D IY
लिये	L IH Y EY
मिलेगा	M IH L EY G AA
बसाया	B AH S AA Y AA
बेगम	B EY G AH M
फिक्र	F IH K R
ड्रिल	D R IH L
गोल्फ	G OW L F
विडियो	W IH D IH Y OW
वैक्स	W AE K S
प्राइमरी	P R AA IH M AH R IY
राजनीति	R AA JH AH N IY T IH
प्रथमेश	P R AH TH AH M EY SH
प्रेशर	P R EY SH AH R
फायबर	F AA Y AH B AH R
पढ़ा	P AH DH AA
आचरण	AA CH AH R AH N
मैग्ना	M AE G N AA
मृत्यु	M R IH T Y UH
सामाजिक	S AA M AA JH IH K
मिठाईयाँ	M IH TH AA IY Y AA N
फोन्स	F OW N S
भयो	B HH AH Y OW
प्लीज	P L IY JH
सोलंकी	S OW L AH N K IY
परायण	P AH R AA Y AH N
चौकोन	CH AO K OW N
कोट	K OW T
विलियम	W IH L IH Y AH M
लगे	L AH G EY
मदरबोर्ड	M AH D AH R AH B OW R D
वैसल्स	W AE S AH L S
साथियों	S AA TH IH Y OW N
निर्णय	N IH R N AH Y
अल्टो	AH L T OW
टेबल	T EY B AH L
भरने	B HH AH R AH N EY
शीतल	SH IY T AH L
सूर्या	S UW R Y AA
फोकस	F OW K AH S
स्वान	S W AA N
कैबिनेट	K AE B IH N EY T
बिंगो	B IH N G OW
शॉर्ट्स	SH AO R T S
कहा	K AH HH AA
हमने	HH AH M AH N EY
बिन्गो	B IH N G OW
ड्रैसेज़	D R AE S EY JH
आम्रपाली	AA M R AH P AA L IY
जगनेर	JH AH G AH N EY R
सावंत	S AA W AH N T
हज़ार	HH AH JH AA R
गणेश	G AH N EY SH
रुकावट	R UH K AA W AH T
अन्तरिक्ष	AH N T AH R IH K SH
डोर	D OW R
चेहरे	CH EY HH AH R EY
होल्डर	HH OW L D AH R
रॉड्ज़	R AO D JH
जूते	JH UW T EY
कैल्सियम	K AE L S IH Y AH M
बनैगी	B AH N AE G IY
आश्वासन	AA SH W AA S AH N
ह्यूमिडीटी	HH Y UW M IH D IY T IY
होता	HH OW T AA
ज़ोलो	JH OW L OW
पैंसिल	P AE N S IH L
माईक्रोमैक्स	M AA IY K R OW M AE K S
निर्वाचित	N IH R W AA CH IH T
वरना	W AH R AH N AA
स्टडी	S T AH D IY
रहे	R AH HH EY
इकलौता	IH K AH L AO T AA
गयी	G AH Y IY
कावासाकी	K AA W AA S AA K IY
अर्जियां	AH R JH IH Y AA N
ऑर्डर	AO R D AH R
पत्रों	P AH T R OW N
वंडरशेफ	W AH N D AH R AH SH EY F
अर्बन	AH R B AH N
मिले	M IH L EY
ग्रह	G R AH HH
डिज़ाइन	D IH JH AA IH N
साईकिल	S AA IY K IH L
अधिकारी	AH DH IH K AA R IY
धुप	DH UH P
कार्पेट्स	K AA R P EY T S
हूटर	HH UW T AH R
अमलपुर	AH M AH L AH P UH R
मन	M AH N
आजादी	AA JH AA D IY
सोनी	S OW N IY
महिलाओं	M AH HH IH L AA OW N
रहस्य	R AH HH AH S Y
फिल्टर	F IH L T AH R
खेतों	K HH EY T OW N
आसमां	AA S AH M AA N
भागलपुर	B HH AA G AH L AH P UH R
जाती	JH AA T IY
इनस्टॉल	IH N AH S T AO L
करेंगे	K AH R EY N G EY
लट्ठम	L AH T TH AH M
विदेशी	W IH D EY SH IY
कोष	K OW SH
पेडिक्यूर	P EY D IH K Y UW R
मतलब	M AH T AH L AH B
ब्लेड	B L EY D
एक्ज़िक्यूट	EY K JH IH K Y UW T
पतसंस्था	P AH T AH S AH N S TH AA
टीम	T IY M
प्रेओशा	P R EY OW SH AA
गद्दा	G AH D D AA
कल्याण	K AH L Y AA N
समाचार	S AH M AA CH AA R
नोवाफिट	N OW W AA F IH T
स्पाइसेज़	S P AA IH S EY JH
सिम	S IH M
नाशिक	N AA SH IH K
हैमर	HH AE M AH R
काश	K AA SH
मंडल	M AH N D AH L
बहोत	B AH HH OW T
पाने	P AA N EY
ज़ोखिम	JH OW K HH IH M
भौमवार	B HH AO M AH W AA R
जाड़ों	JH AA D OW N
गरुड	G AH R UH D
निवीया	N IH W IY Y AA
शांतिपर्व	SH AA N T IH P AH R W
पेढ़ा	P EY DH AA
हिन्दी	HH IH N D IY
सन	S AH N
लर्निंग	L AH R N IH N G
शूल	SH UW L
टैलीफोन	T AE L IY F OW N
सॉफ्टवेयर	S AO F T AH W EY Y AH R
दस्तखत	D AH S T AH K HH AH T
प्रत्येक	P R AH T Y EY K
फर्श	F AH R SH
रिसेप्शन	R IH S EY P SH AH N
तवा	T AH W AA
यह	Y AH HH
जिपर	JH IH P AH R
फ़ास्ट	F AA S T
कैज़ूअल	K AE JH UW AH L
गाड़ा	G AA D AA
क्रीएटीन	K R IY EY T IY N
धोबी	DH OW B IY
आत्मगत	AA T M AH G AH T
कल्कि	K AH L K IH
पैशनेट	P AE SH AH N EY T
ग्राइंडर	G R AA IH N D AH R
पाकिस्तानी	P AA K IH S T AA N IY
बीमा	B IY M AA
बखेड़ों	B AH K HH EY D OW N
गर्भाधान	G AH R B HH AA DH AA N
युद्ध	Y UH D DH
हौंडा	HH AO N D AA
चेन्नई	CH EY N N IY
क्रॉकरी	K R AO K AH R IY
बेहतर	B EY HH AH T AH R
दरो	D AH R OW
निकल	N IH K AH L
इलेक्टॉनिक्स	IH L EY K T AO N IH K S
मॉर्निंग	M AO R N IH N G
देते	D EY T EY
बाढ़	B AA DH
डायना	D AA Y AH N AA
बनाओ	B AH N AA OW
सैनडिस्क	S AE N AH D IH S K
फॉर्म	F AO R M
टीवीएस	T IY W IY EY S
याजुषी	Y AA JH UH SH IY
सदस्यों	S AH D AH S Y OW N
जली	JH AH L IY
चाबी	CH AA B IY
हम	HH AH M
मन्त्र	M AH N T R
कंपनी	K AH M P AH N IY
पेपर	P EY P AH R
मूविंग	M UW W IH N G
परंपरा	P AH R AH M P AH R AA
सफाई	S AH F AA IY
निरे	N IH R EY
कमजोरी	K AH M AH JH OW R IY
दखल	D AH K HH AH L
देखना	D EY K HH AH N AA
दिखाई	D IH K HH AA IY
सा	S AA
नटराजन	N AH T AH R AA JH AH N
ऑडीयो	AO D IY Y OW
पॉजिटिव	P AO JH IH T IH W
रौशनी	R AO SH AH N IY
देखता	D EY K HH AH T AA
रिमूवर	R IH M UW W AH R
शिखर	SH IH K HH AH R
अभिव्यक्त	AH B HH IH W Y AH K T
जैतून	JH AE T UW N
इम्ब्रेस	IH M B R EY S
दिसंबर	D IH S AH M B AH R
कैसे	K AE S EY
पेरी	P EY R IY
स्टार	S T AA R
स्वच्छ	S W AH CH CH
हल्की	HH AH L K IY
एडिशन	EY D IH SH AH N
मिताशि	M IH T AA SH IH
आयोजन	AA Y OW JH AH N
मुहांसों	M UH HH AA N S OW N
माउथ	M AA UH TH
यंत्र	Y AH N T R
सँभाली	S AH N B HH AA L IY
जागतिक	JH AA G AH T IH K
वंशावली	W AH N SH AA W AH L IY
गौरव	G AO R AH W
जूनी	JH UW N IY
वॉचेस	W AO CH EY S
डीलिंक	D IY L IH N K
मंक	M AH N K
भूगोल	B HH UW G OW L
रौबदार	R AO B AH D AA R
नौसेना	N AO S EY N AA
इसी	IH S IY
पुत्र	P UH T R
अलावा	AH L AA W AA
चप्पल	CH AH P P AH L
गांगल	G AA N G AH L
दाढ़ी	D AA DH IY
मूंगफली	M UW N G AH F AH L IY
कैसिओ	K AE S IH OW
खुद	K HH UH D
कृपालु	K R IH P AA L UH
रेलवेज़	R EY L AH W EY JH
सीम	S IY M
आस्वादों	AA S W AA D OW N
मजदूरों	M AH JH AH D UW R OW N
टोकरी	T OW K AH R IY
ले	L EY
ज्वेलरी	JH W EY L AH R IY
मुगल	M UH G AH L
उड़ाने	UH D AA N EY
बैलेनो	B AE L EY N OW
नेहरू	N EY HH AH R UW
सल्वारज़	S AH L W AA R AH JH
पढाई	P AH DH AA IY
कैलिफोर्निया	K AE L IH F OW R N IH Y AA
राजेश्वर	R AA JH EY SH W AH R
रतलाम	R AH T AH L AA M
महत्त्व	M AH HH AH T T W
वैशाली	W AE SH AA L IY
उजर	UH JH AH R
ज़हन्नुम	JH HH AH N N UH M
दौड़ा	D AO D AA
कनेक्टिंग	K AH N EY K T IH N G
ताप	T AA P
पोर्टेबल	P OW R T EY B AH L
कोज़ी	K OW JH IY
दवाखाना	D AH W AA K HH AA N AA
शपथ	SH AH P AH TH
सौन्दर्य	S AO N D AH R Y
देता	D EY T AA
फेंगशुई	F EY N G AH SH UH IY
संगीत	S AH N G IY T
लालिमा	L AA L IH M AA
मौका	M AO K AA
जज	JH AH JH
अवकाशग्रहण	AH W AH K AA SH AH G R AH HH AH N
जाना	JH AA N AA
शायरी	SH AA Y AH R IY
केबल	K EY B AH L
आफ्टर	AA F T AH R
हीरो	HH IY R OW
मॉनिटर	M AO N IH T AH R
थिएटर	TH IH EY T AH R
कुकवेयर	K UH K AH W EY Y AH R
शब्दों	SH AH B D OW N
बॉक्स	B AO K S
पोलो	P OW L OW
वक्त	W AH K T
जादू	JH AA D UW
ड्युअल	D Y UH AH L
चाहूँगा	CH AA HH UW N G AA
अंग	AH N G
उल्टे	UH L T EY
लट्ठा	L AH T TH AA
नायकी	N AA Y AH K IY
फ्रैग्रैन्सेज	F R AE G R AE N S EY JH
कॉस्मेटिक	K AO S M EY T IH K
प्रोटीन	P R OW T IY N
पाठ	P AA TH
पड़ेगा	P AH D EY G AA
मोबाइल	M OW B AA IH L
महेश	M AH HH EY SH
घटाएं	G HH AH T AA EY N
टचस्क्रीन	T AH CH AH S K R IY N
सोचा	S OW CH AA
समग्र	S AH M AH G R
लाइफ़बॉय	L AA IH F B AO Y
देती	D EY T IY
ऊंट	UW N T
खान	K HH AA N
में	M EY N
लगा	L AH G AA
राजस्थान	R AA JH AH S TH AA N
गयीं	G AH Y IY N
मुकाम	M UH K AA M
कैसा	K AE S AA
स्वागत	S W AA G AH T
गोदरेज	G OW D AH R EY JH
बाती	B AA T IY
निर्णयों	N IH R N AH Y OW N
कूलर्स	K UW L AH R S
जिसकी	JH IH S AH K IY
औरेलिया	AO R EY L IH Y AA
विश्व	W IH SH W
सुप्रसिद्ध	S UH P R AH S IH D DH
टाइमेक्स	T AA IH M EY K S
मामले	M AA M AH L EY
धीमे	DH IY M EY
सीरप	S IY R AH P
फसल	F AH S AH L
लहरा	L AH HH AH R AA
रसोई	R AH S OW IY
बैवरेजेज़	B AE W AH R EY JH EY JH
वास्तुशास्त्र	W AA S T UH SH AA S T R
वाला	W AA L AA
मनुस्मृति	M AH N UH S M R IH T IH
द्वारा	D W AA R AA
गोलियाँ	G OW L IH Y AA N
मल्टीप्लेक्स	M AH L T IY P L EY K S
काले	K AA L EY
कॉइन्स	K AO IH N S
रूई	R UW IY
लिंक	L IH N K
मोटोरोला	M OW T OW R OW L AA
चार्ज	CH AA R JH
तालाब	T AA L AA B
ट्यूज़डे	T Y UW JH D EY
माइक्रोमैक्स	M AA IH K R OW M AE K S
मैरून	M AE R UW N
अपेक्षा	AH P EY K SH AA
दुल्हन	D UH L HH AH N
एक्सएल	EY K S EY L
धोने	DH OW N EY
कितनी	K IH T AH N IY
शुक्ल	SH UH K L
बस	B AH S
मल्टीटेस्टर	M AH L T IY T EY S T AH R
दरवाज़ा	D AH R AH W AA JH AA
मनी	M AH N IY
उपेक्षा	UH P EY K SH AA
हां	HH AA N
सिर	S IH R
किसान	K IH S AA N
ज्वेलर्स	JH W EY L AH R S
काउंटर	K AA UH N T AH R
तीज़ेन	T IY JH EY N
दरियागंज	D AH R IH Y AA G AH N JH
व्यवसाय	W Y AH W AH S AA Y
बनो	B AH N OW
शहनाज	SH AH HH AH N AA JH
तुम्हें	T UH M HH EY N
मेन्स	M EY N S
दर्शाता	D AH R SH AA T AA
लड्डू	L AH D D UW
उल्लेख	UH L L EY K HH
नीलकंठ	N IY L AH K AH N TH
मिट्टी	M IH T T IY
वेट	W EY T
सिलाई	S IH L AA IY
निकटतम	N IH K AH T AH T AH M
लगाना	L AH G AA N AA
मॉइस्चराइजर	M AO IH S CH AH R AA IH JH AH R
भाषाएं	B HH AA SH AA EY N
मारा	M AA R AA
सामग्री	S AA M AH G R IY
सुगंधी	S UH G AH N DH IY
बीटेल	B IY T EY L
लॉस	L AO S
वहाँ	W AH HH AA N
याराना	Y AA R AA N AA
समर्थन	S AH M AH R TH AH N
मार्कंडेय	M AA R K AH N D EY Y
चीनी	CH IY N IY
साबून	S AA B UW N
इत्र	IH T R
दंडनीय	D AH N D AH N IY Y
बूटेदार	B UW T EY D AA R
ऍरोमा	R OW M AA
तारांकित	T AA R AA N K IH T
एमडीएच	EY M AH D IY EY CH
मूल	M UW L
पतंजलि	P AH T AH N JH AH L IH
चॉकलेट	CH AO K AH L EY T
बिना	B IH N AA
गोलियों	G OW L IH Y OW N
रिवोक	R IH W OW K
ग्रहों	G R AH HH OW N
इंतजाम	IH N T AH JH AA M
अमोघ	AH M OW G HH
ऐ	AE
जाएगा	JH AA EY G AA
उजागर	UH JH AA G AH R
चलती	CH AH L AH T IY
हैपी	HH AE P IY
भाकरवडी	B HH AA K AH R AH W AH D IY
नारंगी	N AA R AH N G IY
तू	T UW
हैवेल्स	HH AE W EY L S
पैम्पर्ज़	P AE M P AH R JH
चश्मा	CH AH SH M AA
फिटनेस	F IH T AH N EY S
बदली	B AH D AH L IY
रोलेक्स	R OW L EY K S
मसक्युटो	M AH S AH K Y UH T OW
पाजामा	P AA JH AA M AA
थीं	TH IY N
समाजशास्त्र	S AH M AA JH AH SH AA S T R
प्लास्टिक	P L AA S T IH K
गुणकारी	G UH N AH K AA R IY
बिनाटोन	B IH N AA T OW N
प्रश्न	P R AH SH N
क्लाउड	K L AA UH D
कितना	K IH T AH N AA
पांच	P AA N CH
दफह	D AH F AH HH
तो	T OW
उम्मीद	UH M M IY D
बुद्धू	B UH D DH UW
किताबों	K IH T AA B OW N
लावा	L AA W AA
न	N
कैंची	K AE N CH IY
सबेर	S AH B EY R
सबके	S AH B AH K EY
आदर्श	AA D AH R SH
वाइजर	W AA IH JH AH R
शैक्षणिक	SH AE K SH AH N IH K
नाईट	N AA IY T
कांजीवरम	K AA N JH IY W AH R AH M
कक्षा	K AH K SH AA
होगी	HH OW G IY
खून	K HH UW N
वालों	W AA L OW N
बाइक्स	B AA IH K S
तिजोरी	T IH JH OW R IY
जोबोन	JH OW B OW N
एपिलेटर	EY P IH L EY T AH R
अभिभाषण	AH B HH IH B HH AA SH AH N
एक्सचेंज	EY K S AH CH EY N JH
नौकर	N AO K AH R
थी	TH IY
एकॉस्टिक	EY K AO S T IH K
नोकिआ	N OW K IH AA
लॉकेट	L AO K EY T
मिलेगी	M IH L EY G IY
निकोबार	N IH K OW B AA R
चिढ़	CH IH DH
फर्क	F AH R K
अनमोल	AH N AH M OW L
नाइन	N AA IH N
खिंचते	K HH IH N CH AH T EY
लालजी	L AA L AH JH IY
किये	K IH Y EY
घूमना	G HH UW M AH N AA
डिलिवरी	D IH L IH W AH R IY
डेटाविंड	D EY T AA W IH N D
बनाये	B AH N AA Y EY
उधर	UH DH AH R
सप्रे	S AH P R EY
पहुँचूंगा	P AH HH UH N CH UW N G AA
कवर	K AH W AH R
डिओडोरेंट्स	D IH OW D OW R EY N T S
वुडलैंड	W UH D AH L AE N D
हो	HH OW
निकली	N IH K AH L IY
टण्टो	T AH N T OW
स्पीकिंग	S P IY K IH N G
दैनिक	D AE N IH K
ड्रम	D R AH M
आयरन	AA Y AH R AH N
जेबीएल	JH EY B IY EY L
चाहोगे	CH AA HH OW G EY
कॉफ़ी	K AO F IY
संविधान	S AH N W IH DH AA N
लैक्मे	L AE K M EY
कथाएं	K AH TH AA EY N
काउच	K AA UH CH
जाते	JH AA T EY
खोदने	K HH OW D AH N EY
प्रसाधन	P R AH S AA DH AH N
टैक्सी	T AE K S IY
कुंदन	K UH N D AH N
व्यवस्थापन	W Y AH W AH S TH AA P AH N
कचरे	K AH CH AH R EY
ब्राउन	B R AA UH N
सचमुच	S AH CH AH M UH CH
दर्शन	D AH R SH AH N
रामलाल	R AA M AH L AA L
कैसी	K AE S IY
हाई	HH AA IY
डाइनिंग	D AA IH N IH N G
सिवान	S IH W AA N
उस	UH S
जिसे	JH IH S EY
जनम	JH AH N AH M
धर्म	DH AH R M
वर्ग	W AH R G
रिमुवल	R IH M UH W AH L
वियर	W IH Y AH R
बारिश	B AA R IH SH
ज़ैब्रोनिक्स	JH AE B R OW N IH K S
रखी	R AH K HH IY
चैन	CH AE N
ज़रा	JH R AA
ओला	OW L AA
डेंट	D EY N T
प्लस	P L AH S
कपड़ों	K AH P AH D OW N
ठीक	TH IY K
मेज़	M EY JH
पावरबैंक	P AA W AH R AH B AE N K
अलवर	AH L AH W AH R
तुम्हारा	T UH M HH AA R AA
ओवरकोट	OW W AH R AH K OW T
बा	B AA
दोस्ताने	D OW S T AA N EY
ब्रदर्स	B R AH D AH R S
साम्प्रदायिक	S AA M P R AH D AA Y IH K
व्यवहारों	W Y AH W AH HH AA R OW N
कपडे	K AH P AH D EY
शौकिया	SH AO K IH Y AA
सन्ग्लासेज	S AH N G L AA S EY JH
गिरी	G IH R IY
अंग्रेज़ी	AH N G R EY JH IY
उठ	UH TH
पुरुषों	P UH R UH SH OW N
थैंक	TH AE N K
नजदीक	N AH JH AH D IY K
धमाकों	DH AH M AA K OW N
एम	EY M
से	S EY
नांय	N AA N Y
सांप्रदायिक	S AA M P R AH D AA Y IH K
बांग्लादेश	B AA N G L AA D EY SH
सिंदूर	S IH N D UW R
इज़	IH JH
ऑफिसियल	AO F IH S IH Y AH L
वाशिंग	W AA SH IH N G
पश्चात	P AH SH CH AA T
रिकवरी	R IH K AH W AH R IY
उसकी	UH S AH K IY
स्वरुप	S W AH R UH P
पोर्टोनिक्स	P OW R T OW N IH K S
तहत	T AH HH AH T
पाठ्यक्रम	P AA TH Y AH K R AH M
गॉड	G AO D
बधाई	B AH DH AA IY
फ्रूट्स	F R UW T S
पालन	P AA L AH N
विंडो	W IH N D OW
सक्षम	S AH K SH AH M
गुडाकेश	G UH D AA K EY SH
कोर्ट	K OW R T
ओपल	OW P AH L
इसका	IH S AH K AA
फॅशन	F SH AH N
महाभारत	M AH HH AA B HH AA R AH T
जवाहरात	JH AH W AA HH AH R AA T
हंसकर	HH AH N S AH K AH R
पोस्ट	P OW S T
जहाँ	JH AH HH AA N
पुमा	P UH M AA
पहुँच	P AH HH UH N CH
भोपाली	B HH OW P AA L IY
मुबारक	M UH B AA R AH K
सर्वश्रेष्ठ	S AH R W AH SH R EY SH TH
केक	K EY K
स्पार्क्स	S P AA R K S
टीवीऐस	T IY W IY AE S
दवाईयाँ	D AH W AA IY Y AA N
गुणात्मक	G UH N AA T M AH K
समुद्र	S AH M UH D R
साड़ियाँ	S AA D IH Y AA N
अर्जुन	AH R JH UH N
विद्युत्	W IH D Y UH T
नैपकिन	N AE P AH K IH N
ठंडाई	TH AH N D AA IY
मुझसे	M UH ZH AH S EY
ग्लोव्स	G L OW W S
उपयोगी	UH P AH Y OW G IY
चुप	CH UH P
जूसर	JH UW S AH R
जायेगी	JH AA Y EY G IY
कोशिश	K OW SH IH SH
दिल्ली	D IH L L IY
मुलाक़ात	M UH L AA K AA T
मूर्ति	M UW R T IH
फॉसिल	F AO S IH L
विंटर	W IH N T AH R
पेनड्राईव	P EY N AH D R AA IY W
प्राणायाम	P R AA N AA Y AA M
फिल्म	F IH L M
टूरिस्टर	T UW R IH S T AH R
झंडा	ZH AH N D AA
किवी	K IH W IY
टिफिन्स	T IH F IH N S
माली	M AA L IY
फॉक्स	F AO K S
गिटार्स	G IH T AA R S
स्वीकार	S W IY K AA R
लिखित	L IH K HH IH T
दिनों	D IH N OW N
लगेज	L AH G EY JH
लुमिया	L UH M IH Y AA
किताब	K IH T AA B
लेती	L EY T IY
व्यायाम	W Y AA Y AA M
वैजिटेरियन	W AE JH IH T EY R IH Y AH N
खात्मा	K HH AA T M AA
क्रेन	K R EY N
अन्य	AH N Y
धन्य	DH AH N Y
काम्बो	K AA M B OW
बीबीसी	B IY B IY S IY
पन्द्रह	P AH N D R AH HH
बेकार	B EY K AA R
नजर	N AH JH AH R
घबराएँ	G HH AH B AH R AA EY N
स्लो	S L OW
आलस्य	AA L AH S Y
हीटर	HH IY T AH R
लक्ष्मीनारायण	L AH K SH M IY N AA R AA Y AH N
कमीज	K AH M IY JH
अचार	AH CH AA R
रखती	R AH K HH AH T IY
डाबर	D AA B AH R
हलजोत	HH AH L AH JH OW T
प्राइस	P R AA IH S
रचते	R AH CH AH T EY
न्यूट्रिशन	N Y UW T R IH SH AH N
डाउन	D AA UH N
गए	G EY
स्टीरियो	S T IY R IH Y OW
रहिये	R AH HH IH Y EY
चक्की	CH AH K K IY
हु	HH UH
क्लीनिंग	K L IY N IH N G
आंखे	AA N K HH EY
फार्मा	F AA R M AA
यूरोपीय	Y UW R OW P IY Y
खोसला	K HH OW S AH L AA
किनारी	K IH N AA R IY
पेअर्स	P EY AH R S
मोजे	M OW JH EY
नदी	N AH D IY
जाए	JH AA EY
मैंने	M AE N N EY
केबिल	K EY B IH L
जगह	JH AH G AH HH
ट्वैल्व	T W AE L W
ट्वैल्व(2)	T W AE L
नरेश	N AH R EY SH
प्रारंभ	P R AA R AH M B HH
गाउन	G AA UH N
मीटिंग	M IY T IH N G
ब्लेन्ड	B L EY N D
ओसामा	OW S AA M AA
जहाज	JH AH HH AA JH
जासूसी	JH AA S UW S IY
ई	IY
ऐलईडी	AE L IY D IY
जाति	JH AA T IH
एम्लीफायर	EY M L IY F AA Y AH R
खेत	K HH EY T
चलाने	CH AH L AA N EY
दी	D IY
प्रॉपर्टीज़	P R AO P AH R T IY JH
आगरा	AA G AH R AA
मानोगे	M AA N OW G EY
फाऊंटन	F AA UW N T AH N
फ़िल्टर	F IH L T AH R
पसंद	P AH S AH N D
बयान	B AH Y AA N
अ	AH
पिजन	P IH JH AH N
इन्डोवैस्टर्न	IH N D OW W AE S T AH R N
कॉपी	K AO P IY
स्पर्धा	S P AH R DH AA
लक्मे	L AH K M EY
लीड्ज	L IY D JH
अक्टूबर	AH K T UW B AH R
देवगण	D EY W AH G AH N
समर्पित	S AH M AH R P IH T
शादी	SH AA D IY
रकम	R AH K AH M
साधकर	S AA DH AH K AH R
इनरवीअर	IH N AH R AH W IY AH R
विरेल्स	W IH R EY L S
मार्गदर्शन	M AA R G AH D AH R SH AH N
लग	L AH G
फुग्गे	F UH G G EY
फ़िरोज़	F IH R OW JH
बारहवीं	B AA R AH HH AH W IY N
सीमित	S IY M IH T
पानी	P AA N IY
पंडित	P AH N D IH T
भीगा	B HH IY G AA
लकड़ी	L AH K AH D IY
एग्जामिनेशन	EY G JH AA M IH N EY SH AH N
अच्छे	AH CH CH EY
धनी	DH AH N IY
हौज	HH AO JH
फिर	F IH R
डायपर	D AA Y AH P AH R
श्रीवास्तव	SH R IY W AA S T AH W
टु	T UH
अली	AH L IY
कहीं	K AH HH IY N
ब्युटी	B Y UH T IY
गर्मियों	G AH R M IH Y OW N
सोनीगरा	S OW N IY G AH R AA
वेबसाइटों	W EY B AH S AA IH T OW N
चल	CH AH L
चूड़ीदार	CH UW D IY D AA R
बातोंको	B AA T OW N K OW
प्रदर्शित	P R AH D AH R SH IH T
रूस	R UW S
ऍडम	D AH M
ऑफर	AO F AH R
कनैक्ट	K AH N AE K T
बाकौ	B AA K AO
लिपस्टिक	L IH P AH S T IH K
क्लॉथ	K L AO TH
पूछताछ	P UW CH AH T AA CH
लीड	L IY D
दिवाली	D IH W AA L IY
अंगठी	AH N G AH TH IY
तथा	T AH TH AA
केपरीज़	K EY P AH R IY JH
हुयी	HH UH Y IY
चला	CH AH L AA
खिलौने	K HH IH L AO N EY
राजधानी	R AA JH AH DH AA N IY
खुदा	K HH UH D AA
वॉश	W AO SH
वॉलीबाल	W AO L IY B AA L
फ़ोन	F OW N
व्यक्तित्व	W Y AH K T IH T W
चसका	CH AH S AH K AA
डिवाइन	D IH W AA IH N
हॉकिन्स	HH AO K IH N S
तुझे	T UH ZH EY
कुटुंब	K UH T UH M B
खड़ाऊँ	K HH AH D AA UW N
पुरकर	P UH R AH K AH R
आहुजा	AA HH UH JH AA
एंट्रेंस	EY N T R EY N S
उपलब्धियों	UH P AH L AH B DH IH Y OW N
सोफा	S OW F AA
ड्राइव	D R AA IH W
डैल	D AE L
क्लीनर	K L IY N AH R
फौग	F AO G
रोगों	R OW G OW N
आइलैंड	AA IH L AE N D
ग्वालियर	G W AA L IH Y AH R
बटी	B AH T IY
गूजरों	G UW JH AH R OW N
सके	S AH K EY
खाना	K HH AA N AA
रचित	R AH CH IH T
रहते	R AH HH AH T EY
बूढ़ी	B UW DH IY
प्रिन्टेड	P R IH N T EY D
थैरपी	TH AE R AH P IY
लेह	L EY HH
चूर्ण	CH UW R N
शीट	SH IY T
ओप्पो	OW P P OW
पैंट	P AE N T
सकता	S AH K AH T AA
क्षेत्र	K SH EY T R
सिम्टेक	S IH M T EY K
जरूर	JH AH R UW R
डेक्कन	D EY K K AH N
हमरो	HH AH M AH R OW
टाईटेनियम	T AA IY T EY N IH Y AH M
करनौ	K AH R AH N AO
रूढ़िवादी	R UW DH IH W AA D IY
सामने	S AA M AH N EY
विज्ञानं	W IH G Y AA N AH N
डिप्टी	D IH P T IY
वॉल	W AO L
जबानी	JH AH B AA N IY
प्रादेशिक	P R AA D EY SH IH K
नोटबुक्स	N OW T AH B UH K S
कैजुअल	K AE JH UH AH L
कौन	K AO N
हैदराबाद	HH AE D AH R AA B AA D
वाह	W AA HH
स्लाइसर	S L AA IH S AH R
किलिनर	K IH L IH N AH R
हथियार	HH AH TH IH Y AA R
साल	S AA L
रोगियों	R OW G IH Y OW N
गादी	G AA D IY
जोतने	JH OW T AH N EY
अभिप्राय	AH B HH IH P R AA Y
दिसम्बर	D IH S AH M B AH R
उपाय	UH P AA Y
चीज़	CH IY JH
लक्ज़ूरी	L AH K JH UW R IY
हिज़	HH IH JH
फ्लेवर	F L EY W AH R
एल	EY L
सूचना	S UW CH AH N AA
गोल्ड	G OW L D
बचत	B AH CH AH T
प्रसन्नता	P R AH S AH N N AH T AA
फाइव	F AA IH W
आइरन	AA IH R AH N
गिफ्ट	G IH F T
गुड्डा	G UH D D AA
थोड़े	TH OW D EY
प्रगाढ़	P R AH G AA DH
टाईटन	T AA IY T AH N
गुरु	G UH R UH
बीज	B IY JH
सोसायटी	S OW S AA Y AH T IY
पेंट्स	P EY N T S
आनेवाले	AA N EY W AA L EY
स्वेट	S W EY T
चार्जर	CH AA R JH AH R
गुड	G UH D
थामकर	TH AA M AH K AH R
थियेटर	TH IH Y EY T AH R
प्रोटीन्स	P R OW T IY N S
नॉन	N AO N
सिंदुर	S IH N D UH R
वस्तुएं	W AH S T UH EY N
तक	T AH K
शाम	SH AA M
कलफ	K AH L AH F
दोनों	D OW N OW N
बाद	B AA D
थाली	TH AA L IY
कप्तान	K AH P T AA N
सिले	S IH L EY
सैवेन	S AE W EY N
राजा	R AA JH AA
शेल्व्स	SH EY L W S
उठाता	UH TH AA T AA
पटवारी	P AH T AH W AA R IY
कैमरा	K AE M AH R AA
भाषाओं	B HH AA SH AA OW N
कर्जा	K AH R JH AA
गांधीजी	G AA N DH IY JH IY
जेल	JH EY L
शूज़	SH UW JH
के	K EY
आम	AA M
म्यूजिकल	M Y UW JH IH K AH L
स्लिपर	S L IH P AH R
वर्काउट	W AH R K AA UH T
ध्यान	DH Y AA N
नेगेटिव	N EY G EY T IH W
बापै	B AA P AE
जमीन	JH AH M IY N
हवा	HH AH W AA
सप्लीमेंट	S AH P L IY M EY N T
ब्ल्यूटूथ	B L Y UW T UW TH
सल्वार	S AH L W AA R
गोल्डन	G OW L D AH N
माइक्रोस्कोप	M AA IH K R OW S K OW P
शॉपिंग	SH AO P IH N G
शिष्य	SH IH SH Y
ज़ालिमों	JH AA L IH M OW N
थर्मस	TH AH R M AH S
कूलर	K UW L AH R
तालमेल	T AA L AH M EY L
ज़ूम	JH UW M
जगत	JH AH G AH T
पूछता	P UW CH AH T AA
जिंदाबाद	JH IH N D AA B AA D
वीडियोकॉन	W IY D IH Y OW K AO N
लाओ	L AA OW
बेवकूफ	B EY W AH K UW F
जैसा	JH AE S AA
खोआ	K HH OW AA
वेशभूषा	W EY SH AH B HH UW SH AA
ब्लु	B L UH
सेफटी	S EY F AH T IY
पढ़ाते	P AH DH AA T EY
सेमी	S EY M IY
डिज़ाइनदार	D IH JH AA IH N AH D AA R
स्वीटर्स	S W IY T AH R S
बिगड़	B IH G AH D
रोग	R OW G
जन्म	JH AH N M
प्रोफेशनल	P R OW F EY SH AH N AH L
कोबाल्ट	K OW B AA L T
सिंगल	S IH N G AH L
मेरा	M EY R AA
इन्हीं	IH N HH IY N
माने	M AA N EY
लूमीया	L UW M IY Y AA
प्रस्ताव	P R AH S T AA W
जूलरी	JH UW L AH R IY
निश्चित	N IH SH CH IH T
आबो	AA B OW
फ्लॉवर	F L AO W AH R
फ्लॉवर(2)	F L AO W ER
दूरदर्शन	D UW R D AH R SH AH N
इन्फोकुस	IH N F OW K UH S
इन्फोकस	IH N F OW K AH S
डीप	D IY P
हमरौ	HH AH M AH R AO
कूपर	K UW P AH R
वस्तुओं	W AH S T UH OW N
तिरंगा	T IH R AH N G AA
जाऊँ	JH AA UW N
सुकरात	S UH K AH R AA T
गद्दे	G AH D D EY
साऊथ	S AA UW TH
रसोइ	R AH S OW IH
कदम्बखेर	K AH D AH M B AH K HH EY R
भारत	B HH AA R AH T
ब	B AH
इस्तेमाल	IH S T EY M AA L
सर्वस्व	S AH R W AH S W
कामन्स	K AA M AH N S
धंधे	DH AH N DH EY
बाँध	B AA N DH
नैचुरल्स	N AE CH UH R AH L S
बोलचाल	B OW L AH CH AA L
बीजगणित	B IY JH AH G AH N IH T
एंड	EY N D
सिद्धि	S IH D DH IH
पहले	P AH HH AH L EY
एनफील्ड	EY N AH F IY L D
वह	W AH HH
इ	IH
डाटा	D AA T AA
छिहत्तर	CH IH HH AH T T AH R
सिनेमा	S IH N EY M AA
सुभाष	S UH B HH AA SH
काफी	K AA F IY
धर्मरक्षक	DH AH R M AH R AH K SH AH K
झूठे	ZH UW TH EY
आशा	AA SH AA
दयालु	D AH Y AA L UH
आयकर	AA Y AH K AH R
टेलिस्कोप	T EY L IH S K OW P
वॉट	W AO T
भगवद्गीता	B HH AH G AH W AH D G IY T AA
डॉल्स	D AO L S
आयुर्वेदिक	AA Y UH R W EY D IH K
मना	M AH N AA
सबआरडिनेट	S AH B AA R AH D IH N EY T
लोहे	L OW HH EY
धातु	DH AA T UH
डृाई	D R IH AA IY
कामाख्या	K AA M AA K HH Y AA
सुनता	S UH N AH T AA
सिद्धांत	S IH D DH AA N T
खास	K HH AA S
कॉम्प्लान	K AO M P L AA N
ब्लू	B L UW
सेहत	S EY HH AH T
डोसा	D OW S AA
आजम	AA JH AH M
ज़रूरी	JH R UW R IY
एक्स्प्रेस	EY K S P R EY S
पार्टी	P AA R T IY
चूल्हा	CH UW L HH AA
रात	R AA T
प्रधान	P R AH DH AA N
चेन	CH EY N
बॉन्ड्स	B AO N D S
स्टे	S T EY
विवो	W IH W OW
नेमराज	N EY M AH R AA JH
लिबर्टी	L IH B AH R T IY
पीतल	P IY T AH L
ज़्यादा	JH Y AA D AA
उसको	UH S AH K OW
किसानों	K IH S AA N OW N
वीमेन	W IY M EY N
बेर	B EY R
हैंड	HH AE N D
अजीब	AH JH IY B
बॉडी	B AO D IY
खराब	K HH AH R AA B
कलक्टरसाहब	K AH L AH K T AH R AH S AA HH AH B
सीट	S IY T
पीटर	P IY T AH R
चरिबे	CH AH R IH B EY
आउट	AA UH T
नहाने	N AH HH AA N EY
विश्लेषण	W IH SH L EY SH AH N
शकुंतला	SH AH K UH N T AH L AA
चिन्तक	CH IH N T AH K
वेस्टर्न	W EY S T AH R N
कमर्शीयल	K AH M AH R SH IY Y AH L
उन्नीस	UH N N IY S
फ़ूड	F UW D
चेक्स	CH EY K S
उत्तुंग	UH T T UH N G
क्यूंकि	K Y UW N K IH
यूपीपीएसी	Y UW P IY P IY EY S IY
चादर	CH AA D AH R
लोकप्रिय	L OW K AH P R IH Y
तहसीलदार	T AH HH AH S IY L AH D AA R
गेलेक्सी	G EY L EY K S IY
शांतनु	SH AA N T AH N UH
हैंडसैट	HH AE N D AH S AE T
डेकोर	D EY K OW R
कन्या	K AH N Y AA
खरबों	K HH AH R AH B OW N
कफ़न	K AH F N
लेबनान	L EY B AH N AA N
कुर्सियों	K UH R S IH Y OW N
कर्नाटकी	K AH R N AA T AH K IY
स्पार्क	S P AA R K
कुकर	K UH K AH R
ऐरावत	AE R AA W AH T
साईनाथ	S AA IY N AA TH
कील	K IY L
पंच	P AH N CH
मोटरसाइकिल	M OW T AH R AH S AA IH K IH L
धूप	DH UW P
सामान्य	S AA M AA N Y
गैंस	G AE N S
प्रतिभूति	P R AH T IH B HH UW T IH
रहो	R AH HH OW
कुर्सी	K UH R S IY
कसम	K AH S AH M
शुरु	SH UH R UH
दुनियाभर	D UH N IH Y AA B HH AH R
मैथमैटिक्स	M AE TH AH M AE T IH K S
अमेरिका	AH M EY R IH K AA
राजेंद्र	R AA JH EY N D R
स्थानीय	S TH AA N IY Y
चश्मे	CH AH SH M EY
संघ	S AH N G HH
उपयोग	UH P AH Y OW G
वाली	W AA L IY
कालिदास	K AA L IH D AA S
तरक्की	T AH R AH K K IY
मिलापचंद	M IH L AA P AH CH AH N D
काजल	K AA JH AH L
स्मार्टफोन	S M AA R T AH F OW N
स्विफ्ट	S W IH F T
झूला	ZH UW L AA
लक्षण	L AH K SH AH N
ओंकार	OW N K AA R
चमत्कार	CH AH M AH T K AA R
सीखें	S IY K HH EY N
कैलेंडर	K AE L EY N D AH R
कॉम्बोज	K AO M B OW JH
लाल	L AA L
फैक्ट्री	F AE K T R IY
संक्रामक	S AH N K R AA M AH K
करेगा	K AH R EY G AA
सभा	S AH B HH AA
घर	G HH AH R
सिग्नल	S IH G N AH L
वस्तु	W AH S T UH
टेनिस	T EY N IH S
ट्रेंड्ज़	T R EY N D JH
पचपन	P AH CH AH P AH N
सुनाई	S UH N AA IY
जोखा	JH OW K HH AA
बढ़	B AH DH
अपना	AH P AH N AA
मेनका	M EY N AH K AA
बैद्यनाथ	B AE D Y AH N AA TH
अधिक	AH DH IH K
प्रिंटर्स	P R IH N T AH R S
सेफ्टी	S EY F T IY
बोलने	B OW L AH N EY
उपलब्ध	UH P AH L AH B DH
पैरागन	P AE R AA G AH N
डूबे	D UW B EY
उससे	UH S AH S EY
लेलैंड	L EY L AE N D
फिटिंग	F IH T IH N G
वॉलेट	W AO L EY T
तुलना	T UH L AH N AA
जनता	JH AH N AH T AA
पेशवा	P EY SH AH W AA
श्याम	SH Y AA M
ग्रीष्म	G R IY SH M
आदर	AA D AH R
बोर्ड	B OW R D
संपूर्ण	S AH M P UW R N
इन्स्ट्रुमेंट्स	IH N S T R UH M EY N T S
दुनिया	D UH N IH Y AA
अभ्यास	AH B Y AA S
घोड़ा	G HH OW D AA
अमिताभ	AH M IH T AA B HH
स्टैचू	S T AE CH UW
देखे	D EY K HH EY
रोक	R OW K
गैजेट्स	G AE JH EY T S
फीचर्स	F IY CH AH R S
तकाबी	T AH K AA B IY
सत्र	S AH T R
लघु	L AH G HH UH
स्वांग	S W AA N G
हैलमेट	HH AE L AH M EY T
रिबोक	R IH B OW K
संतूर	S AH N T UW R
ओरिफ्लेम	OW R IH F L EY M
बचपन	B AH CH AH P AH N
एयरलाइनर	EY Y AH R AH L AA IH N AH R
मनोरंजन	M AH N OW R AH N JH AH N
कोच	K OW CH
दिग्विजय	D IH G W IH JH AH Y
ठाक	TH AA K
ओर	OW R
नाइकी	N AA IH K IY
सुपरमार्केट	S UH P AH R AH M AA R K EY T
टिकली	T IH K AH L IY
एक्स्क्लूसिव्स	EY K S K L UW S IH W S
ही	HH IY
दैव	D AE W
हाय	HH AA Y
फास्टफूड	F AA S T AH F UW D
समाधि	S AH M AA DH IH
अगंभीर	AH G AH M B HH IY R
विविधकलाओं	W IH W IH DH AH K AH L AA OW N
अफ़गानिस्तान	AH F G AA N IH S T AA N
डे	D EY
राधे	R AA DH EY
ट्वेंटी	T W EY N T IY
नोकीया	N OW K IY Y AA
यानि	Y AA N IH
शुल्क	SH UH L K
बूढ़े	B UW DH EY
सेमसंग	S EY M AH S AH N G
बनाएं	B AH N AA EY N
सेंडविच	S EY N D AH W IH CH
नारे	N AA R EY
नज़र	N AH JH R
स्टूल	S T UW L
मैदान	M AE D AA N
बात	B AA T
सिखाने	S IH K HH AA N EY
सैर	S AE R
वूड	W UW D
जिन्हें	JH IH N HH EY N
कम्पैटिबल	K AH M P AE T IH B AH L
धुन्ध	DH UH N DH
खोजक	K HH OW JH AH K
वहां	W AH HH AA N
इंग्लिश	IH N G L IH SH
सौर	S AO R
ली	L IY
लाइन	L AA IH N
पुराण	P UH R AA N
औषध	AO SH AH DH
लगाता	L AH G AA T AA
पॉट्स	P AO T S
कंगा	K AH N G AA
दगडु	D AH G AH D UH
बिल्कुल	B IH L K UH L
चले	CH AH L EY
आई	AA IY
गुज़ारा	G UH JH AA R AA
कैट	K AE T
पौधे	P AO DH EY
ब्रीज	B R IY JH
स्टिचिंग	S T IH CH IH N G
महिंद्रा	M AH HH IH N D R AA
माँ	M AA N
होली	HH OW L IY
अपितु	AH P IH T UH
दादा	D AA D AA
बुधवार	B UH DH AH W AA R
भरती	B HH AH R AH T IY
दो	D OW
दाम	D AA M
सूत	S UW T
लैमन	L AE M AH N
मैट्स	M AE T S
बनारस	B AH N AA R AH S
क्लीन	K L IY N
जिन्होंने	JH IH N HH OW N N EY
देर	D EY R
हुए	HH UH EY
एक	EY K
फोर्ब्स	F OW R B S
गाज़	G AA JH
घड़ी	G HH AH D IY
विशारद	W IH SH AA R AH D
कसर	K AH S AH R
खुल्लर	K HH UH L L AH R
पीछे	P IY CH EY
असामियों	AH S AA M IH Y OW N
एंटरप्राइजेज़	EY N T AH R AH P R AA IH JH EY JH
बाहुबली	B AA HH UH B AH L IY
यक़ीन	Y AH K IY N
रैक	R AE K
पाइप	P AA IH P
कुआं	K UH AA N
लेकिन	L EY K IH N
सम्मेलन	S AH M M EY L AH N
फास्ट्रैक	F AA S T R AE K
क्राफ्ट	K R AA F T
चाहीए	CH AA HH IY EY
लोग	L OW G
पत्थर	P AH T TH AH R
मूल्यांकनों	M UW L Y AA N K AH N OW N
लगाया	L AH G AA Y AA
फर	F AH R
मित्र	M IH T R
ऑइल	AO IH L
शेव	SH EY W
कोल्गते	K OW L G AH T EY
सोलह	S OW L AH HH
खपाता	K HH AH P AA T AA
ऍंड्रॉइड	N D R AO IH D
सभागृह	S AH B HH AA G R IH HH
टूथपेस्ट	T UW TH AH P EY S T
सोसाइटी	S OW S AA IH T IY
खुशबू	K HH UH SH AH B UW
स्टेट	S T EY T
गुरूवार	G UH R UW W AA R
जिमफिट	JH IH M AH F IH T
गोभी	G OW B HH IY
फाइलें	F AA IH L EY N
लक्ष्य	L AH K SH Y
न्यूज़	N Y UW JH
अनिकेत	AH N IH K EY T
भोलेनाथ	B HH OW L EY N AA TH
नागाओं	N AA G AA OW N
गुलाबी	G UH L AA B IY
ललित	L AH L IH T
ब्राइडल	B R AA IH D AH L
बच्चे	B AH CH CH EY
मॉप	M AO P
गावों	G AA W OW N
दस	D AH S
पाण्डुकाका	P AA N D UH K AA K AA
कहते	K AH HH AH T EY
ऐनक	AE N AH K
किश्तों	K IH SH T OW N
इंच	IH N CH
व्यक्त	W Y AH K T
गैलक्सी	G AE L AH K S IY
इत्यादि	IH T Y AA D IH
वर्क्स	W AH R K S
पेब्ब्लेयर्द	P EY B B L EY Y AH R D
शॉप	SH AO P
त्रिपाठी	T R IH P AA TH IY
यामाहा	Y AA M AA HH AA
फर्मिंग	F AH R M IH N G
बजट	B AH JH AH T
व्यावहारिक	W Y AA W AH HH AA R IH K
उसके	UH S AH K EY
ओये	OW Y EY
आखिर	AA K HH IH R
कठिन	K AH TH IH N
पारदर्शी	P AA R AH D AH R SH IY
करनी	K AH R AH N IY
चाईम	CH AA IY M
बच्चा	B AH CH CH AA
नकली	N AH K AH L IY
विराट	W IH R AA T
शायद	SH AA Y AH D
बेंगलूरू	B EY N G AH L UW R UW
अध्यक्ष	AH DH Y AH K SH
सिंह	S IH N HH
शांत	SH AA N T
राग	R AA G
अच्छा	AH CH CH AA
तेरे	T EY R EY
मुनाफे	M UH N AA F EY
ड्रायर	D R AA Y AH R
मापी	M AA P IY
विद्यार्थी	W IH D Y AA R TH IY
परिणाम	P AH R IH N AA M
एमएससी	EY M EY S AH S IY
धनुआ	DH AH N UH AA
एलईडी	EY L IY D IY
अप्टु	AH P T UH
लेनोवो	L EY N OW W OW
ज़िन्दगी	JH IH N D AH G IY
जो	JH OW
वेब	W EY B
उठे	UH TH EY
बिज़नस	B IH JH N AH S
धरमपुर	DH AH R AH M AH P UH R
षोडश	SH OW D AH SH
अखबार	AH K HH AH B AA R
प्रैशर	P R AE SH AH R
पायजेब	P AA Y AH JH EY B
लेता	L EY T AA
वातानुकूलित	W AA T AA N UH K UW L IH T
साटम	S AA T AH M
चाकू	CH AA K UW
कलर	K AH L AH R
भरलेली	B HH AH R AH L EY L IY
सफलता	S AH F AH L AH T AA
व	W
त्रेपन	T R EY P AH N
हार्दिक	HH AA R D IH K
घट	G HH AH T
फणीश्वर	F AH N IY SH W AH R
ऑटोमेटिक	AO T OW M EY T IH K
गाइड	G AA IH D
चुम्बकीय	CH UH M B AH K IY Y
बूट्स	B UW T S
विकास	W IH K AA S
जीने	JH IY N EY
विंड	W IH N D
अविष्कार	AH W IH SH K AA R
टैलीविज़न	T AE L IY W IH JH N
लगानी	L AH G AA N IY
रीडिंग	R IY D IH N G
देसी	D EY S IY
भोजनालय	B HH OW JH AH N AA L AH Y
रेसलिंग	R EY S AH L IH N G
रिक्त	R IH K T
आज	AA JH
बार्बी	B AA R B IY
कार	K AA R
स्लीपिंग	S L IY P IH N G
सकती	S AH K AH T IY
लड़ाई	L AH D AA IY
फुल	F UH L
कार्टरिजेज़	K AA R T AH R IH JH EY JH
शो	SH OW
उन	UH N
शिशु	SH IH SH UH
मंथ्रालय	M AH N TH R AA L AH Y
आप	AA P
टमाटर	T AH M AA T AH R
ड्यूटी	D Y UW T IY
प्रथमत	P R AH TH AH M AH T
बस्ती	B AH S T IY
टैबलेट्स	T AE B AH L EY T S
ऊर्जा	UW R JH AA
लौंग	L AO N G
मकान	M AH K AA N
जुनेजा	JH UH N EY JH AA
टूल्स	T UW L S
बीस	B IY S
गोल	G OW L
शेर	SH EY R
डिब्बा	D IH B B AA
मोटर	M OW T AH R
बीमारी	B IY M AA R IY
चाह	CH AA HH
बातों	B AA T OW N
निष्ठा	N IH SH TH AA
शीट्स	SH IY T S
मटिया	M AH T IH Y AA
प्रश्नोतरी	P R AH SH N OW T AH R IY
प्रयास	P R AH Y AA S
स्वेटर	S W EY T AH R
रिमुवर	R IH M UH W AH R
रिमूवर	R IH M UW V ER
रिमूवर(2)	R IH M UW V ER
रिमूवर(3)	R IH M UW W AH R
इन्फिनिटी	IH N F IH N IH T IY
राऊटर	R AA UW T AH R
दशकों	D AH SH AH K OW N
अतः	AH T AH HH
प्रथमतः	P R AH TH AH M AH T AH HH
प्रथमतः	P R AH TH AH M T AH HH
मुस्कुरा	M UH S K UH R AA
audiovox	AO D IY OW V AA K S
bullish	B UH L IH SH
rajkumar	R AA ZH K UW M AA R
hood	HH UH D
vastu	V AE S T UW
footnote	F UH T N OW T
selfie	S EH L F IY
tejasvi	T AH JH AE Z IY
moshai	M AA SH EY
uni	Y UW N IY
skydo	S K AY D UW
santosh	S AA N T AA SH
tree	T R IY
young	Y AH NG
pure	P Y UH R
boo	B UW
navigator	N AE V AH G EY T ER
cell	S EH L
leg	L EH G
deathly	D EH TH L IY
lky	L K AY
hopper	HH AA P ER
gel	JH EH L
bijoli	B AY JH OW L IY
cowabunga	K AW AH B AH N G AH
rajco	R AE JH K OW
zebra	Z IY B R AH
diya	D AY AY AH
zooey	Z UW IY
owl	AW L
h	EY CH
storm	S T AO R M
bear	B EH R
view	V Y UW
holder	HH OW L D ER
shooter	SH UW T ER
chopper	CH AA P ER
derma	D ER M AH
sanctuary	S AE NG K CH UW EH R IY
robinhood	R AA B IH N HH UH D
space	S P EY S
cut	K AH T
mauza	M AO Z AH
edge	EH JH
loohon	L UW HH AH N
squared	S K W EH R D
spiked	S P AY K T
share	SH EH R
guarantee	G EH R AH N T IY
savings	S EY V IH NG Z
louise	L UW IY Z
fame	F EY M
fsa	F S AA
scotch	S K AA CH
shizuoka	SH IY Z W OW K AH
sowbaghya	S OW B AE AY AH
cows	K AW Z
wow	W AW
hoo	HH UW
smell	S M EH L
girl	G ER L
angel	EY N JH AH L
river	R IH V ER
pearls	P ER L Z
bury	B EH R IY
koizer	K OW AY Z AH R
thepariya	TH EH P AH R IY AY AH
vu	V UW
quik	K W IH K
samrat	S AE M R AH T
topwin	T AA P W IH N
antelope	AE N T AH L OW P
fetch	F EH CH
feather	F EH DH ER
touareg	T UW ER AH G
weave	W IY V
bows	B AW Z
bows(2)	B OW Z
end	EH N D
sishodiya	S IH SH AH D IY AY AH
hope	HH OW P
lead	L EH D
lead(2)	L IY D
sculpture	S K AH L P CH ER
tank	T AE NG K
sleep	S L IY P
shaheed	SH AH HH IY D
daffodil	D AE F AH D IH L
time	T AY M
rob	R AA B
yuva	Y UW V AH
true	T R UW
agri	AE G R IY
stick	S T IH K
wildfire	W AY L D F AY ER
sat	S AE T
shoing	SH UW IH NG
tough	T AH F
garment	G AA R M AH N T
baishida	B EY SH AH D AH
bar	B AA R
spy	S P AY
aiwa	AY W AH
favor	F EY V ER
ishtyle	IH SH T AY L
mochdi	M AA CH D IY
briefcase	B R IY F K EY S
micro	M AY K R OW
billionaire	B IH L Y AH N EH R
hayward	HH EY W ER D
jute	JH UW T
sell	S EH L
sushma	S AH SH M AH
wood	W UH D
protegent	P R OW T AH ZH EY AH N T
trip	T R IH P
go	G OW
designs	D IH Z AY N Z
fowl	F AW L
regenerative	R IY JH EH N ER AH T IH V
squeegee	S K W IY JH IY
vibes	V AY B Z
phase	F EY Z
shreshth	SH R EH SH TH
pray	P R EY
haveli	HH AE V AH L IY
inscribed	IH N S K R AY B D
sunoindia	S UW N OY N D IY AH
hues	HH Y UW Z
dhoom	D HH UW M
rosanna	R OW Z AE N AH
fighter	F AY T ER
ice	AY S
less	L EH S
protective	P R AH T EH K T IH V
tweepi	T W IY P IY
mouth	M AW TH
number	N AH M B ER
exact	IH G Z AE K T
slave	S L EY V
hariom	HH AE R IY AH M
silvery	S IH L V ER IY
shoe	SH UW
horn	HH AO R N
joycoon	JH OY K UW N
giftadia	JH IH F T EY D IY AH
vault	V AO L T
vertex	V ER T EH K S
skinny	S K IH N IY
meandering	M IY AE N D ER IH NG
tag	T AE G
door	D AO R
max	M AE K S
mute	M Y UW T
shadow	SH AE D OW
rejoice	R IH JH OY S
avenue	AE V AH N UW
ifja	IH F JH AH
susajjit	S UW S AE JH AH T
beginning	B IH G IH N IH NG
powell	P AW AH L
powell(2)	P AA W EH L
stuff	S T AH F
hard	HH AA R D
fly	F L AY
jinaaya	JH AH N AA AY AH
portal	P AO R T AH L
drop	D R AA P
drop(2)	D R AO P
awwmaze	AO W M EY Z
ayu	EY UW
night	N AY T
man	M AE N
wash	W AA SH
compatible	K AH M P AE T AH B AH L
cup	K AH P
shekhawati	SH EH K AO AH T IY
repose	R IY P OW Z
sacrifice	S AE K R AH F AY S
wolf	W UH L F
exalt	IH G Z AO L T
floor	F L AO R
indo	IH N D OW
chalk	CH AA K
chalk(2)	CH AO K
spoke	S P OW K
worth	W ER TH
lampshade	L AE M P SH EY D
neer	N IH R
gio	JH AY OW
apoyo	AE P OY OW
hair	HH EH R
bay	B EY
beach	B IY CH
crave	K R EY V
mom	M AA M
lifebuoy	L AY F B OY
huawei	HH Y UW AH IY
dog	D AO G
min	M IH N
yes	Y EH S
ethnics	EH TH N IH K S
shade	SH EY D
astha	AE S TH AH
wand	W AA N D
colleges	K AA L IH JH IH Z
rack	R AE K
vaishma	V EY SH M AH
bee	B IY
impex	IH M P EH K S
village	V IH L AH JH
village(2)	V IH L IH JH
razor	R EY Z ER
rep	R EH P
rep(2)	R EH P R IY Z EH T AH T IH V
french	F R EH N CH
westing	W EH S T IH NG
tube	T UW B
tube(2)	T Y UW B
keep	K IY P
tune	T UW N
guys	G AY Z
corning	K AO R N IH NG
grass	G R AE S
bandhan	B AE N D AH N
touch	T AH CH
roger	R AA JH ER
rising	R AY Z IH NG
pocoyo	P AA K OY OW
lengthwise	L EH NG TH W AY Z
gems	JH EH M Z
chaitanya	CH EY T AE N AY AH
somay	S OW M AH IY
benchmark	B EH N CH M AA R K
suryakant	S ER Y AE K AH N T
luggage	L AH G AH JH
luggage(2)	L AH G IH JH
karrfit	K AE R F AH T
engagement	EH N G EY JH M AH N T
posterior	P AO S T IH R Y ER
g	JH IY
switch	S W IH CH
well	W EH L
behoof	B IH HH UW F
mob	M AA B
kusum	K Y UW S AH M
pophead	P AA P HH EH D
sunder	S AH N D ER
daawat	D AA W AH T
chairs	CH EH R Z
show	SH OW
zepzop	Z EH P Z AH P
soft	S AA F T
soft(2)	S AO F T
front	F R AH N T
shapers	SH EY P ER Z
fad	F AE D
benzo	B IH N Z OW
hands	HH AE N D Z
hands(2)	HH AE N Z
merch	M AH R CH
rais	R EY S
market	M AA R K AH T
market(2)	M AA R K IH T
pages	P EY JH AH Z
pages(2)	P EY JH IH Z
haat	HH AA T
hanged	HH AE NG D
cube	K Y UW B
heavy	HH EH V IY
type	T AY P
dew	D UW
datta	D AE T AH
spot	S P AA T
joi	JH OY
rosetta	R OW Z EH T AH
razai	R AE Z EY
footcare	F UH T K EH R
bewitch	B IH W IH CH
pro	P R OW
sonic	S AA N IH K
allowing	AH L AW IH NG
wembley	W EH M B L IY
margarita	M AA R G ER IY T AH
shaolin	SH AA OW L IH N
funny	F AH N IY
xyloid	Z AY L OY D
v	V IY
threads	TH R EH D Z
chill	CH IH L
balance	B AE L AH N S
aamanee	AH AH M EY N IY
deja	D IY JH AH
deja(2)	D EY ZH AA
off	AO F
therapy	TH EH R AH P IY
chek	CH EH K
ride	R AY D
lab	L AE B
kingsoft	K IH NG S AO F T
mega	M EH G AH
heal	HH IY L
chogaji	CH AA G AH JH IY
green	G R IY N
woinc	W OY NG K
hound	HH AW N D
ear	IY R
ear(2)	IH R
oye	OY
bioelements	B AY OW EH L AH M AH N T S
ray	R EY
speech	S P IY CH
corn	K AO R N
zoysia	Z OY ZH IY AH
sof	S AA F
microphone	M AY K R AH F OW N
motorola	M OW T ER OW L AH
fab	F AE B
aashitha	AA SH AH TH AH
glaze	G L EY Z
mayoo	M EY UW
commando	K AH M AE N D OW
isbn	AY EH S B IY EH N
hook	HH UH K
deepu	D IY EH P UW
pot	P AA T
todler	T OW D L AH R
cutting	K AH T IH NG
grey	G R EY
rahee	R AE IY IY
mboss	M B AA S
kalp	K AE L P
relay	R IY L EY
bud	B AH D
yuhao	Y AH HH EY OW
rubberised	R AH B AH R IY Z D
foil	F OY L
hoyle	HH OY L
belzona	B IH L Z AA N AH
out	AW T
greeting	G R IY T IH NG
web	W EH B
decore	D IY K OW R
beat	B IY T
sky	S K AY
leach	L IY CH
jbi	JH B IY
cuff	K AH F
m	EH M
flame	F L EY M
chilling	CH IH L IH NG
juice	JH UW S
road	R OW D
stopper	S T AA P ER
bow	B AW
bow(2)	B OW
eighth	EY T TH
eighth(2)	EY TH
akoya	AE K OY AH
chouhan	CH AW AH N
colorful	K AH L ER F AH L
fundoo	F AH N D UW
track	T R AE K
divya	D IH V AY AH
advent	AE D V EH N T
y	W AY
breathe	B R IY DH
vogue	V OW G
bijou	B AY JH UW
memoire	M EH M OW AY ER
odhni	AA D HH N IY
mansarovar	M AE N Z AH R OW V ER
leaf	L IY F
roget	R OW ZH EY
white	W AY T
white(2)	HH W AY T
kurta	K UW R T AA
kurta(2)	K AH R T AH
rhythms	R IH DH AH M Z
galore	G AH L AO R
beekay	B AH EH K EY IY
strech	S T R EH CH
shuttle	SH AH T AH L
boyanika	B OY AE N AH K AH
sifco	S IH F K OW
screen	S K R IY N
aayushi	AA AY AH SH IY
holding	HH OW L D IH NG
gal	G AE L
flamboyance	F L AE M B OY AH N S
plastwood	P L AE S T W UW D
cabin	K AE B AH N
henniger	HH EH N AY JH AH R
disney	D IH Z N IY
leoma	L IH OW M AH
shathayu	SH AE TH EY UW
check	CH EH K
wiesel	W IY S AH L
cathode	K AE TH OW D
asia	EY ZH AH
dash	D AE SH
hawk	HH AO K
vastra	V AE S T R AH
comfort	K AH M F ER T
sassy	S AE S IY
marshalls	M AA R SH AO L Z
ware	W EH R
toyvilla	T OY V IH L AH
ws	D AH B AH L Y UW EH S
ws(2)	D AH B Y AH EH S
zfi	Z F IY
uws	AH W Z
charge	CH AA R JH
golf	G AA L F
golf(2)	G AO L F
cardulis	K AA R D UW L IY Z
fire	F AY ER
fire(2)	F AY R
youth	Y UW TH
mount	M AW N T
kaaya	K AA AY AH
ships	SH IH P S
gath	G AE TH
shield	SH IY L D
x	EH K S
google	G UW G AH L
pets	P EH T S
adda	AE D AH
sathiya	S AH TH IY AY AH
onshine	AO N SH AY N
hill	HH IH L
clay	K L EY
indy	IH N D IY
wala	W AO L AH
zero	Z IH R OW
zero(2)	Z IY R OW
digi	D IH JH IY
mongoose	M AA NG G UW S
suits	S UW T S
street	S T R IY T
elephant	EH L AH F AH N T
zee	Z IY
dyco	D AY K OW
growlers	G R AW L ER Z
fisheries	F IH SH ER IY Z
pahnawas	P AE N AH AH Z
chicks	CH IH K S
cook	K UH K
childhood	CH AY L D HH UH D
swaroop	S W AH R UW P
e	IY
mesmerization	M EH Z M AH R AY Z EY SH AH N
walla	W AO L AA
jhingu	JH HH IH N G Y UW
ortho	AO R TH OW
paolo	P AW L OW
perchmount	P ER CH M AW N T
colourful	K AH L ER F AH L
safe	S EY F
edit	EH D AH T
aqua	AE K W AH
aqua(2)	AA K W AH
soundbase	S AW N D B EY S
voyager	V OY AH JH ER
voyager(2)	V OY IH JH ER
htc	EY CH T IY S IY
htc(2)	EY CH T IY K
flowers	F L AW ER Z
heroes	HH IH R OW Z
heroes(2)	HH IY R OW Z
uth	AH TH
hosiery	HH OW ZH ER IY
jaipur	JH EY P AH R
padamshree	P AE D AH M SH R IY IY
monaz	M AA N AH Z
krish	K R IH SH
dispowear	D IH S OW IY AH R
camouflage	K AE M AH F L AA ZH
yoshi	Y OW SH IY
couch	K AW CH
dvaita	D V EY T AH
matter	M AE T ER
mart	M AA R T
tohfa	T AA F AH
os	AA S
suite	S W IY T
mitsoi	M IH T S OY
aid	EY D
clothier	K L OW DH Y ER
whale	W EY L
whale(2)	HH W EY L
visualize	V IH ZH W AH L AY Z
side	S AY D
break	B R EY K
berry	B EH R IY
koushik	K AW SH AH K
lady	L EY D IY
jog	JH AA G
coaching	K OW CH IH NG
rohit	R AA HH AH T
egoist	IY G OW IH S T
geeta	JH IY T AH
pea	P IY
dragon	D R AE G AH N
tirth	T AH R TH
hang	HH AE NG
seamless	S IY M L AH S
paparazzi	P AA P AA R AO Z IY
ville	V IH L
rudrayay	R AH D R EY EY IY
shave	SH EY V
gujtron	G AH JH T R AH N
vaivasvata	V EY V AE Z AH T AH
jewels	JH UW AH L Z
jewels(2)	JH UW L Z
stage	S T EY JH
raghu	R AH G HH UH
pigeon	P IH JH AH N
pigeon(2)	P IH JH IH N
bunk	B AH NG K
shubh	SH AH B
यार्ड	Y AA R D
मल्टीकलर	M AH L T IY K AH L AH R
पैबल	P AE B AH L
