सैंट	 S AE N T
सीरप	 S IY R AH P
औन	 AO N
नागाज़	 N AA G AA Z
बूक	 B UH K
शपथ	 SH AH P AH TH
लंच	 L AH N CH
गाउन	 G AA UW N
मदरबोर्ड	 M AH D AH R AH B OW R D
वॉच	 W AO CH
इंटेल	 IH N T EY L
पुरूस	 P UW R UH S
जैकेट्स	 JH AE K EY T S
पेनड्राईव	 P EY N AH D R AA IY W
चनिया	 CH AH N IH Y AA
सोनी	 S OW N IY
रिंग	 R IH N G
स्पोर्ट	 S P OW R T
पार्टी	 P AA R T IY
सायकल	 S AA Y AH K AH L
इंटेक्स	 IH N T EY K S
हेलमेट	 HH EY L AH M EY T
डेटा	 D EY T AA
बूटेदार	 B UH T EY D AA R
ओफो	 OW F OW
गैहने	 G AE HH AH N EY
कैस	 K AE S
एफ़	 EY F
जालीदार	 JH AA L IY D AA R
साड़ियाँ	 S AA D IH Y AA N
केवल	 K EY W AH L
डिझाईन	 D IH JH AA IY N
साइकिल	 S AA IH K IH L
ब्रा	 B R AA
और	 AO R
फ्लॉपी	 F L AO P IY
मोटर	 M OW T AH R
लाइट्स	 L AA IH T S
पीपल	 P IY P AH L
शूज़	 SH UH Z
तैयारी	 T AE Y AA R IY
ऑफ़	 AO F
बायुपुत्राची	 B AA Y UW P UW T R AA CH IY
सादी	 S AA D IY
कपड़ों	 K AH P AH D OW N
रैड	 R AE D
ऐमिरिकन	 AE M IH R IH K AH N
एक्स्टेंडेड	 EY K S T EY N D EY D
मैन्स	 M AE N S
स्टेप	 S T EY P
क्रिकेट	 K R IH K EY T
ड्राइव	 D R AA IH W
गुजराती	 G UW JH AH R AA T IY
फ्रॉक	 F R AO K
ऑफर्ज़	 AO F AH R Z
हंड्रेड	 HH AH N D R EY D
टीवी	 T IY W IY
साइज़	 S AA IH JH
हार्डिस्क	 HH AA R D IH S K
जीवनी	 JH IY W AH N IY
कोर	 K OW R
एसियन	 EY S IH Y AH N
डी	 D IY
होल्डर	 HH OW L D AH R
तेल	 T EY L
प्लस	 P L AH S
फैंसी	 F AE N S IY
कैनर	 K AE N AH R
टूरिस्टर	 T UH R IH S T AH R
वेट	 W EY T
ऑफर	 AO F AH R
हारडिस्क	 HH AA R AH D IH S K
एडम	 EY D AH M
झूला	 JH UH L AA
लेडिज	 L EY D IH JH
एडिडास	 EY D IH D AA S
रेट	 R EY T
राउ	 R AA UW
नाईट	 N AA IY T
कादंबरी	 K AA D AH M B AH R IY
वेस्टर्न	 W EY S T AH R N
डिलिवरी	 D IH L IH W AH R IY
टोपी	 T OW P IY
लीड	 L IY D
नाइक	 N AA IH K
मोवाइल	 M OW W AA IH L
ड्रेस	 D R EY S
स्वेटर	 S W EY T AH R
लिवाइस	 L IH W AA IH S
पैन	 P AE N
डोर	 D OW R
डैल	 D AE L
कवर्स	 K AH W AH R S
विडियो	 W IH D IH Y OW
एम्	 EY M
साड़ीयाँ	 S AA D IY Y AA N
डिज़ाइन	 D IH Z AA IH N
घड़ी	 G HH AH D IY
पकाने	 P AH K AA N EY
बैग	 B AE G
रेल्वे	 R EY L W EY
ब्लाउज	 B L AA UW JH
लेनोवो	 L EY N OW W OW
मोबाइल	 M OW B AA IH L
बेड	 B EY D
वुमेन्स	 W UW M EY N S
इतर	 IH T AH R
रानी	 R AA N IY
प्योअर	 P Y OW AH R
टैरेन	 T AE R EY N
फूल	 F UH L
मेलुहाचे	 M EY L UW HH AA CH EY
स्मार्टफोंस	 S M AA R T AH F OW N S
पूस्तक	 P UH S T AH K
पैकेट	 P AE K EY T
थर्मस	 TH AH R M AH S
मफलर	 M AH F AH L AH R
जोड़ा	 JH OW D AA
फॉर्मल	 F AO R M AH L
झालीदार	 JH AA L IY D AA R
स्किल्स	 S K IH L S
सफेद	 S AH F EY D
छत	 CH AH T
रेड	 R EY D
लैपटॉप	 L AE P AH T AO P
लगेज	 L AH G EY JH
कवर	 K AH W AH R
लेटेस्ट	 L EY T EY S T
का	 K AA
फैन	 F AE N
रैडमी	 R AE D AH M IY
मशीन	 M AH SH IY N
ब्राउन	 B R AA UW N
प्रिंटर्स	 P R IH N T AH R S
सैंडल	 S AE N D AH L
सोना	 S OW N AA
स्मैर्ट	 S M AE R T
मैडम	 M AE D AH M
सोलर	 S OW L AH R
गोल्ड	 G OW L D
मिट्टी	 M IH T T IY
टूल्स	 T UH L S
आराम	 AA R AA M
चप्पल	 CH AH P P AH L
बड़े	 B AH D EY
साड़ीज़	 S AA D IY Z
फ्रक	 F R AH K
ली	 L IY
कपडे	 K AH P AH D EY
प्राइम	 P R AA IH M
चपलचे	 CH AH P AH L AH CH EY
बेबी	 B EY B IY
स्टैंड	 S T AE N D
अमेरिकन	 AH M EY R IH K AH N
ईपसन	 IY P AH S AH N
लेडीज	 L EY D IY JH
एक्स्टर्नल	 EY K S T AH R N AH L
टिफ़ीन्स	 T IH F IY N S
कुर्सी	 K UW R S IY
रींग्स	 R IY N G S
एक्स्पीरिया	 EY K S P IY R IH Y AA
इस्त्री	 IH S T R IY
ड्रिल	 D R IH L
ट्रैवल	 T R AE W AH L
चेक्स	 CH EY K S
किट	 K IH T
लेडीस	 L EY D IY S
बूट्स	 B UH T S
सप्लीमेंट	 S AH P L IY M EY N T
लिबर्टी	 L IH B AH R T IY
सिंथेटिक	 S IH N TH EY T IH K
इंडिको	 IH N D IH K OW
फ़िलीप्स	 F IH L IY P S
कृष्णन	 K R IH SH N AH N
प्लेयर	 P L EY Y AH R
टाइटेनियम	 T AA IH T EY N IH Y AH M
क्लीनर	 K L IY N AH R
फेस	 F EY S
शीट्स	 SH IY T S
साओमी	 S AA OW M IY
परीक्षा	 P AH R IY K SH AA
वीवो	 W IY W OW
स्टार	 S T AA R
साड़ी	 S AA D IY
बच्चे	 B AH CH CH EY
कटन	 K AH T AH N
ब्लूटूथ	 B L UH T UH TH
पीटर	 P IY T AH R
केबल	 K EY B AH L
कूलर	 K UH L AH R
शौपिंग	 SH AO P IH N G
ब्लैक	 B L AE K
पोलो	 P OW L OW
टॉप्स	 T AO P S
सैटटॉप	 S AE T AH T AO P
हात	 HH AA T
सर्ट्स	 S AH R T S
प्रीन्टेड	 P R IY N T EY D
पैंट	 P AE N T
कफ़ी	 K AH F IY
सुलतानी	 S UW L AH T AA N IY
सर्डी	 S AH R D IY
रेडियो	 R EY D IH Y OW
स्टैमिना	 S T AE M IH N AA
सूज	 S UH JH
स्मार्टफोन	 S M AA R T AH F OW N
चोली	 CH OW L IY
डिजाइनर्स	 D IH JH AA IH N AH R S
कम्बो	 K AH M B OW
फिटनेस	 F IH T AH N EY S
लिए	 L IH EY
बूट	 B UH T
पेन	 P EY N
रोड	 R OW D
स्पोर्ट्स	 S P OW R T S
टिपटॉप	 T IH P AH T AO P
फ़ोटो	 F OW T OW
कर्टेन	 K AH R T EY N
मैमोरी	 M AE M OW R IY
सूट	 S UH T
दुल्हन	 D UW L HH AH N
सिंगल	 S IH N G AH L
रेलवे	 R EY L AH W EY
दार	 D AA R
इंडिया	 IH N D IH Y AA
रैक	 R AE K
कुर्तीज	 K UW R T IY JH
फाइव	 F AA IH W
औरेलिया	 AO R EY L IH Y AA
डाटा	 D AA T AA
डायपर	 D AA Y AH P AH R
साड़ी	 S AA D IY
ट्यूनिक्स	 T Y UH N IH K S
गैलेक्सी	 G AE L EY K S IY
माइक्रो	 M AA IH K R OW
सैंडिल	 S AE N D IH L
मेकर	 M EY K AH R
काइट्स	 K AA IH T S
भाव	 B HH AA W
काला	 K AA L AA
लो	 L OW
सोने	 S OW N EY
डबल	 D AH B AH L
अडीयो	 AH D IY Y OW
मोवाईल	 M OW W AA IY L
मृतुन्जय	 M R IH T UW N JH AH Y
पर्स	 P AH R S
फोन	 F OW N
बॉक्स	 B AO K S
केयर	 K EY Y AH R
लेदर	 L EY D AH R
स्किन	 S K IH N
हार	 HH AA R
वेअर	 W EY AH R
सल्वार	 S AH L W AA R
मट्रीअल	 M AH T R IY AH L
बेबीज़	 B EY B IY Z
माइक्रोमैक्स	 M AA IH K R OW M AE K S
कसरत	 K AH S AH R AH T
पेरागौन	 P EY R AA G AO N
जीन्स	 JH IY N S
फ़्लीप	 F L IY P
जैतुन	 JH AE T UW N
कॉस्ट	 K AO S T
बैग्स	 B AE G S
मुलतानी	 M UW L AH T AA N IY
साधन	 S AA DH AH N
कार्ड	 K AA R D
सैमसंग	 S AE M AH S AH N G
शूज	 SH UH JH
तक	 T AH K
कैमरा	 K AE M AH R AA
कुर्ता	 K UW R T AA
बरतन	 B AH R AH T AH N
सेविंग	 S EY W IH N G
रूट	 R UH T
जूता	 JH UH T AA
लैंप	 L AE M P
घागरा	 G HH AA G AH R AA
इन	 IH N
एस	 EY S
एम्ब्रयडरी	 EY M B R AH Y AH D AH R IY
यूनीफॉर्म	 Y UH N IY F AO R M
ग्रैंड	 G R AE N D
इंग्लैंड	 IH N G L AE N D
स्फोर्ट	 S F OW R T
कपड़े	 K AH P AH D EY
खाना	 K HH AA N AA
गेनर	 G EY N AH R
ट्रीमर	 T R IY M AH R
राऊ	 R AA UH
लैदर	 L AE D AH R
अमेरिका	 AH M EY R IH K AA
नाइटी	 N AA IH T IY
आफर्ज़	 AA F AH R Z
मेमोरी	 M EY M OW R IY
बैट्री	 B AE T R IY
जूते	 JH UH T EY
वॉरंटी	 W AO R AH N T IY
ज्वेलरी	 JH W EY L AH R IY
लैहेंगा	 L AE HH EY N G AA
कार्बन	 K AA R B AH N
गेम्स	 G EY M S
लोगों	 L OW G OW N
इंकज़ेट	 IH N K AH Z EY T
इंडियन	 IH N D IH Y AH N
टीसर्ट	 T IY S AH R T
सीक्रेट	 S IY K R EY T
बॉल	 B AO L
रीबोक	 R IY B OW K
नाइट	 N AA IH T
जीम	 JH IY M
के	 K EY
इन्शुरन्स	 IH N SH UW R AH N S
रेडमी	 R EY D AH M IY
टीवीएस	 T IY W IY EY S
मोबाईल	 M OW B AA IY L
डिक्स	 D IH K S
नोट	 N OW T
की	 K IY
वैक्यूम	 W AE K Y UH M
