अंदर	AH N D AH R
अच्छे	AH CH CHH EY
अपनी	AH P AH N IY
अपेक्षा	AH P EY K SH AA
अलंकार	AH L AH N K AA R
अशांति	AH SH AA N T IH
अस्पताल	AH S P AH T AA L
आज	AA JH
आती	AA T IY
आप	AA P
इंद्रायणी	IH N D R AA Y AH NN IY
इनफार्मेशन	IH N AH F AA R M EY SH AH N
उतरेंगे	UH T AH R EY N G EY
उड़ान	UH DD AA N
एक	EY K
एक्सचेंज	EY K S AH CH EY N JH
एक्सप्रेस	EY K S AH P R EY S
ओर	OW R
कनेक्टिंग	K AH N EY K TT IH N G
कब	K AH B
कम	K AH M
कम्बल	K AH M B AH L
कला	K AH L AA
कस्टम्स	K AH S TT AH M S
कहाँ	K AH HH AA N
का	K AA
काउंटर	K AA UH N TT AH R
कार	K AA R
कि	K IH
कितना	K IH T AH N AA
कितनी	K IH T AH N IY
कितने	K IH T AH N EY
किस	K IH S
की	K IY
कुर्सी	K UH R S IY
कृपया	K R IH P AH Y AA
के	K EY
केंद्र	K EY N D R
केलकर	K EY L AH K AH R
कैसे	K AE S EY
को	K OW
कौन	K AO N
कौनसी	K AO N AH S IY
कौनसे	K AO N AH S EY
क्या	K Y AA
क्षतिग्रस्त	K SH AH T IH G R AH S T
खुल	KH UH L
खुलेगा	KH UH L EY G AA
खो	KH OW
खड़ी	KH AH DD IY
गया	G AH Y AA
गयी	G AH Y IY
गाड़ी	G AA DD IY
गिलास	G IH L AA S
चल	CH AH L
चलता	CH AH L AH T AA
चहिए	CH AH HH IH EY
चाहता	CH AA HH AH T AA
छूट	CHH UW TT
जहाँगीर	JH AH HH AA N G IY R
जहाज	JH AH HH AA JH
जाऊँगा	JH AA UW N G AA
जाएगा	JH AA EY G AA
जाता	JH AA T AA
जाती	JH AA T IY
जाते	JH AA T EY
जाना	JH AA N AA
जाने	JH AA N EY
जानेवाली	JH AA N EY W AA L IY
जायेगी	JH AA Y EY G IY
झेलम	JHH EY L AH M
टिकट	TT IH K AH TT
टैक्सी	TT AE K S IY
ठंड	TTH AH N DD
डर	DD AH R
डेक्कन	DD EY K K AH N
डॉक्टर	DD AO K TT AH R
तक	T AH K
थिएटर	TH IH EY TT AH R
दवाखाना	D AH W AA KH AA N AA
दवाखाने	D AH W AA KH AA N EY
दिल्ली	D IH L L IY
दीजिए	D IY JH IH EY
दूर	D UW R
दे	D EY
देंगे	D EY N G EY
नंबर	N AH N B AH R
नर्सिंग	N AH R S IH N G
नहीं	N AH HH IY N
नाटक	N AA TT AH K
पता	P AH T AA
पर	P AH R
पर्यटक	P AH R Y AH TT AH K
पहुँच	P AH HH UH N CH
पानी	P AA N IY
पार्किंग	P AA R K IH N G
पास	P AA S
पासपोर्ट	P AA S AH P OW R TT
पूना	P UW N AA
पेटी	P EY TT IY
पैसे	P AE S EY
प्रदर्शनी	P R AH D AH R SH AH N IY
प्लेटफार्म	P L EY TT AH F AA R M
फिल्म	F IH L M
फॅमिली	F AE M IH L IY
फॉरेन	F AO R EY N
फ्लाइट	F L AA IH TT
बजे	B AH JH EY
बता	B AH T AA
बदल	B AH D AH L
बस	B AH S
बांधें	B AA N DH EY N
बैंक	B AE N K
बोर्डिंग्	B OW R DD IH N G
भूख	BH UW KH
मल्टीप्लेक्स	M AH L TT IY P L EY K S
मिलेगा	M IH L EY G AA
मिलैनियम	M IH L AE N IH Y AH M
मुझसे	M UH JHH AH S EY
मुझे	M UH JHH EY
में	M EY N
मेरा	M EY R AA
मैं	M AE N
मोटल	M OW TT AH L
म्यूजियम	M Y UW JH IH Y AH M
यहाँ	Y AH HH AA N
या	Y AA
युवा	Y UH W AA
रही	R AH HH IY
रेलगाड़ी	R EY L AH G AA DD IY
रेलवे	R EY L AH W EY
लगी	L AH G IY
लिए	L IH EY
लेट	L EY TT
वह	W AH HH
वेस्टएंड	W EY S TT AH EY N DD
शहर	SH AH HH AH R
शांत	SH AA N T
शिबिर	SH IH B IH R
शुरू	SH UH R UW
शुल्क	SH UH L K
संग्रहालय	S AH N G R AH HH AA L AH Y
सकता	S AH K AH T AA
सकते	S AH K AH T EY
सस्ते	S AH S T EY
सामान	S AA M AA N
सिनेमा	S IH N EY M AA
सी	S IY
सीमा	S IY M AA
सुपरमार्केट	S UH P AH R AH M AA R K EY TT
सूचना	S UW CH AH N AA
से	S EY
सेट	S EY TT
सेण्टर	S EY NN TT AH R
स्टेशन	S TT EY SH AH N
स्टैंड	S TT AE N DD
स्टॉप	S TT AO P
हम	HH AH M
हमें	HH AH M EY N
हवाई	HH AH W AA IY
हूँ	HH UW N
हेड	HH EY DD
है	HH AE
हैं	HH AE N
हॉटल	HH AO TT AH L
हॉस्पिटल	HH AO S P IH TT AH L
हो	HH OW
होंगे	HH OW N G EY
होटल	HH OW TT AH L
होती	HH OW T IY
होम	HH OW M
होस्टल	HH OW S TT AH L
ज़्यादा	Z Y AA D AA