AA			A
AE			E
AH			a
AO			O
AW			W
AY			1
B			b
CH			c
D			d
DH			D
EH			H
ER			r
EY			e
F			f
G			g
HH			h
IH			i
IY			I
JH			j
K			k
L			l
M			m
N			n
NG			N
OW			o
OY			Y
P			p
R			R
S			s
SH			S
T			t
TH			T
UH			u
UW			U
V			v
W			w
Y			y
Z			z
ZH			Z
